,Location,Player,Kills,Deaths,K/D,Damage Dealt,Damage Taken,Damage Differential,Side,Total Rounds
0,Lane Side,Ax1Le,5,2,3,523,200,323,CT,160
1,Lane Side,Ax1Le,2,2,0,323,378,-55,T,160
2,Top Balcony ,Ax1Le,4,4,0,647,481,166,CT,160
3,Top Balcony ,Ax1Le,5,6,-1,458,532,-74,T,160
4,Top Mid Chokepoint,Ax1Le,2,1,1,336,176,160,CT,160
5,Top Mid Chokepoint,Ax1Le,2,0,2,226,92,134,T,160
6,Top Mid Lane Side ,Ax1Le,2,0,2,218,44,174,CT,160
7,Top Mid Lane Side ,Ax1Le,0,3,-3,183,213,-30,T,160
8,Chokepoint Entering B,Ax1Le,4,1,3,193,111,82,CT,160
9,Chokepoint Entering B,Ax1Le,3,1,2,256,30,226,T,160
10,Pit Peek Towards Lane,Ax1Le,11,3,8,933,434,499,CT,160
11,Pit Peek Towards Lane,Ax1Le,1,1,0,95,50,45,T,160
12,CT Banana Half Wall Side,Ax1Le,1,1,0,100,49,51,CT,160
13,CT Banana Half Wall Side,Ax1Le,3,2,1,188,267,-79,T,160
14,Top Mid Arch Side,Ax1Le,1,0,1,148,0,148,CT,160
15,Top Mid Arch Side,Ax1Le,3,2,1,221,178,43,T,160
16,B Site,Ax1Le,0,1,-1,0,152,-152,CT,160
17,B Site,Ax1Le,3,1,2,232,163,69,T,160
18,Arch Side,Ax1Le,1,2,-1,87,227,-140,CT,160
19,Arch Side,Ax1Le,3,0,3,276,80,196,T,160
20,Lane Patio,Ax1Le,1,0,1,115,0,115,CT,160
21,Lane Patio,Ax1Le,0,1,-1,0,100,-100,T,160
22,Boiler Room,Ax1Le,1,0,1,100,7,93,CT,160
23,Boiler Room,Ax1Le,0,1,-1,0,129,-129,T,160
24,Deep Apps Past Hallway,Ax1Le,2,1,1,264,120,144,CT,160
25,Deep Apps Past Hallway,Ax1Le,1,2,-1,124,228,-104,T,160
26,Pit,Ax1Le,7,4,3,734,400,334,CT,160
27,Pit,Ax1Le,3,1,2,251,99,152,T,160
28,A Site,Ax1Le,5,0,5,319,112,207,CT,160
29,A Site,Ax1Le,0,0,0,0,0,0,T,160
30,Grill,Ax1Le,0,0,0,0,0,0,CT,160
31,Grill,Ax1Le,0,2,-2,54,123,-69,T,160
32,Pit Below Balcony,Ax1Le,4,2,2,386,207,179,CT,160
33,Pit Below Balcony,Ax1Le,1,0,1,26,0,26,T,160
34,Boiler Side Stairs,Ax1Le,3,1,2,218,132,86,CT,160
35,Boiler Side Stairs,Ax1Le,0,1,-1,35,104,-69,T,160
36,SecondMid,Ax1Le,0,0,0,0,2,-2,CT,160
37,SecondMid,Ax1Le,2,0,2,215,28,187,T,160
38,CT Peek Towards B Choke,Ax1Le,2,2,0,228,283,-55,CT,160
39,CT Peek Towards B Choke,Ax1Le,0,0,0,0,0,0,T,160
40,Outside Library,Ax1Le,0,0,0,0,0,0,CT,160
41,Outside Library,Ax1Le,0,0,0,0,0,0,T,160
42,Banana,Ax1Le,2,0,2,84,0,84,CT,160
43,Banana,Ax1Le,1,1,0,141,99,42,T,160
44,A Bombsite Close Left,Ax1Le,2,1,1,78,70,8,CT,160
45,A Bombsite Close Left,Ax1Le,1,1,0,243,99,144,T,160
46,Lane Behind Pillar,Ax1Le,4,2,2,235,259,-24,CT,160
47,Lane Behind Pillar,Ax1Le,1,0,1,100,0,100,T,160
48,Default Plant A Site,Ax1Le,0,0,0,0,0,0,CT,160
49,Default Plant A Site,Ax1Le,1,0,1,23,16,7,T,160
50,CT Banana Sandbangs,Ax1Le,0,0,0,12,0,12,CT,160
51,CT Banana Sandbangs,Ax1Le,1,1,0,118,58,60,T,160
52,T Ramp Peeking Towards Mid,Ax1Le,0,1,-1,26,98,-72,CT,160
53,T Ramp Peeking Towards Mid,Ax1Le,0,0,0,0,76,-76,T,160
54,Dark,Ax1Le,0,0,0,0,0,0,CT,160
55,Dark,Ax1Le,0,1,-1,12,7,5,T,160
56,Back Alley,Ax1Le,0,0,0,0,0,0,CT,160
57,Back Alley,Ax1Le,4,2,2,408,308,100,T,160
58,Middle,Ax1Le,2,1,1,245,150,95,CT,160
59,Middle,Ax1Le,0,0,0,0,5,-5,T,160
60,Boiler Peek to Mid,Ax1Le,0,0,0,0,1,-1,CT,160
61,Boiler Peek to Mid,Ax1Le,0,1,-1,60,196,-136,T,160
62,CT Boost,Ax1Le,4,2,2,177,279,-102,CT,160
63,CT Boost,Ax1Le,0,0,0,0,0,0,T,160
64,A Site Right Side Middle Pillar,Ax1Le,1,0,1,114,81,33,CT,160
65,A Site Right Side Middle Pillar,Ax1Le,0,0,0,0,0,0,T,160
66,Apps Hallway,Ax1Le,0,0,0,0,25,-25,CT,160
67,Apps Hallway,Ax1Le,2,0,2,201,63,138,T,160
68,CT Arch,Ax1Le,1,0,1,71,0,71,CT,160
69,CT Arch,Ax1Le,0,0,0,0,0,0,T,160
70,Right Side Quadbox Peek for a CT,Ax1Le,0,0,0,0,0,0,CT,160
71,Right Side Quadbox Peek for a CT,Ax1Le,1,1,0,185,72,113,T,160
72,Front Coffins,Ax1Le,0,1,-1,0,48,-48,CT,160
73,Front Coffins,Ax1Le,0,1,-1,0,100,-100,T,160
74,B Site Cross for T's Exposed to CT and Quad,Ax1Le,0,0,0,0,0,0,CT,160
75,B Site Cross for T's Exposed to CT and Quad,Ax1Le,0,2,-2,0,173,-173,T,160
76,CT Banana Barrels,Ax1Le,0,0,0,0,0,0,CT,160
77,CT Banana Barrels,Ax1Le,1,0,1,100,86,14,T,160
78,1st Oranges,Ax1Le,0,0,0,0,0,0,CT,160
79,1st Oranges,Ax1Le,0,0,0,22,0,22,T,160
80,A Bombsite Back Site,Ax1Le,0,0,0,60,0,60,CT,160
81,A Bombsite Back Site,Ax1Le,2,0,2,200,23,177,T,160
82,Apartments Hallway Peek from T Side,Ax1Le,0,1,-1,44,100,-56,CT,160
83,Apartments Hallway Peek from T Side,Ax1Le,0,0,0,11,0,11,T,160
84,A Site Left Side Middle Boxes,Ax1Le,0,0,0,0,0,0,CT,160
85,A Site Left Side Middle Boxes,Ax1Le,0,0,0,0,0,0,T,160
86,Quad Box,Ax1Le,0,0,0,0,0,0,CT,160
87,Quad Box,Ax1Le,0,0,0,0,0,0,T,160
88,Left Side Quadbox Peek for a CT,Ax1Le,1,0,1,100,0,100,CT,160
89,Left Side Quadbox Peek for a CT,Ax1Le,0,0,0,0,0,0,T,160
90,2nd Oranges,Ax1Le,0,0,0,0,0,0,CT,160
91,2nd Oranges,Ax1Le,0,0,0,22,79,-57,T,160
92,CT Outside Kitchen,Ax1Le,0,0,0,0,0,0,CT,160
93,CT Outside Kitchen,Ax1Le,0,0,0,0,0,0,T,160
94,Lane Peek Towards Top Mid,Ax1Le,0,0,0,0,0,0,CT,160
95,Lane Peek Towards Top Mid,Ax1Le,0,0,0,0,0,0,T,160
96,Top Graveyard,Ax1Le,0,0,0,0,0,0,CT,160
97,Top Graveyard,Ax1Le,1,0,1,80,30,50,T,160
98,Next to Library Cubby,Ax1Le,0,1,-1,80,100,-20,CT,160
99,Next to Library Cubby,Ax1Le,0,0,0,0,0,0,T,160
100,Balcony,Ax1Le,0,0,0,0,0,0,CT,160
101,Balcony,Ax1Le,0,0,0,0,0,0,T,160
102,T Apps,Ax1Le,0,1,-1,0,100,-100,CT,160
103,T Apps,Ax1Le,0,0,0,0,0,0,T,160
104,CT Outside Construction,Ax1Le,0,1,-1,22,5,17,CT,160
105,CT Outside Construction,Ax1Le,0,0,0,0,0,0,T,160
106,CT Banana Sandbags Right Corner,Ax1Le,0,0,0,0,0,0,CT,160
107,CT Banana Sandbags Right Corner,Ax1Le,2,1,1,255,117,138,T,160
108,Behind B Site Back Pillar,Ax1Le,0,0,0,0,0,0,CT,160
109,Behind B Site Back Pillar,Ax1Le,0,0,0,78,14,64,T,160
110,Arch Side CT Corner Peeking Towards Top Mid,Ax1Le,0,1,-1,0,21,-21,CT,160
111,Arch Side CT Corner Peeking Towards Top Mid,Ax1Le,0,0,0,0,0,0,T,160
112,CT Spawn ,Ax1Le,1,0,1,100,0,100,CT,160
113,CT Spawn ,Ax1Le,0,1,-1,0,79,-79,T,160
114,Top Hay Bales,Ax1Le,0,0,0,0,0,0,CT,160
115,Top Hay Bales,Ax1Le,0,0,0,0,75,-75,T,160
116,Apps T Side Stairs,Ax1Le,0,0,0,68,0,68,CT,160
117,Apps T Side Stairs,Ax1Le,0,0,0,0,11,-11,T,160
118,Behind Coffins Playing the B Site Cross,Ax1Le,1,0,1,81,0,81,CT,160
119,Behind Coffins Playing the B Site Cross,Ax1Le,1,0,1,52,0,52,T,160
120,Apartments,Ax1Le,0,0,0,11,0,11,CT,160
121,Apartments,Ax1Le,1,1,0,100,146,-46,T,160
122,CT Banana Close Left Half Wall,Ax1Le,0,0,0,0,0,0,CT,160
123,CT Banana Close Left Half Wall,Ax1Le,0,0,0,0,0,0,T,160
124,Deep CT Peeking Towards B Site,Ax1Le,2,0,2,180,48,132,CT,160
125,Deep CT Peeking Towards B Site,Ax1Le,0,0,0,0,0,0,T,160
126,Logs,Ax1Le,0,0,0,0,0,0,CT,160
127,Logs,Ax1Le,0,1,-1,0,100,-100,T,160
128,A Site Behind Default Boxes,Ax1Le,1,1,0,93,100,-7,CT,160
129,A Site Behind Default Boxes,Ax1Le,0,0,0,0,0,0,T,160
130,Chokepoint Entrance onto A site from Library Side,Ax1Le,0,0,0,0,0,0,CT,160
131,Chokepoint Entrance onto A site from Library Side,Ax1Le,0,1,-1,0,100,-100,T,160
132,A Bombsite Close Left,nawwk,0,1,-1,0,106,-106,CT,153
133,A Bombsite Close Left,nawwk,0,8,-8,148,837,-689,T,153
134,Lane Side,nawwk,3,0,3,225,19,206,CT,153
135,Lane Side,nawwk,6,5,1,465,464,1,T,153
136,Banana,nawwk,0,0,0,0,0,0,CT,153
137,Banana,nawwk,4,3,1,367,569,-202,T,153
138,Pit Peek Towards Lane,nawwk,1,1,0,163,88,75,CT,153
139,Pit Peek Towards Lane,nawwk,0,1,-1,81,85,-4,T,153
140,CT Peek Towards B Choke,nawwk,3,1,2,331,197,134,CT,153
141,CT Peek Towards B Choke,nawwk,2,2,0,191,129,62,T,153
142,Top Mid Chokepoint,nawwk,0,0,0,0,0,0,CT,153
143,Top Mid Chokepoint,nawwk,3,2,1,334,473,-139,T,153
144,Arch Side,nawwk,3,0,3,248,50,198,CT,153
145,Arch Side,nawwk,0,2,-2,27,270,-243,T,153
146,Behind Coffins Playing the B Site Cross,nawwk,2,2,0,371,188,183,CT,153
147,Behind Coffins Playing the B Site Cross,nawwk,1,0,1,100,0,100,T,153
148,CT Banana Sandbangs,nawwk,0,0,0,0,1,-1,CT,153
149,CT Banana Sandbangs,nawwk,2,0,2,200,172,28,T,153
150,Chokepoint Entering B,nawwk,2,1,1,145,86,59,CT,153
151,Chokepoint Entering B,nawwk,3,1,2,400,285,115,T,153
152,B Site,nawwk,1,1,0,13,206,-193,CT,153
153,B Site,nawwk,3,0,3,266,72,194,T,153
154,Top Coffins,nawwk,2,1,1,112,100,12,CT,153
155,Top Coffins,nawwk,0,0,0,0,0,0,T,153
156,T Ramp Peeking Towards Mid,nawwk,0,0,0,0,0,0,CT,153
157,T Ramp Peeking Towards Mid,nawwk,2,2,0,232,363,-131,T,153
158,Outside Library,nawwk,2,3,-1,110,223,-113,CT,153
159,Outside Library,nawwk,0,0,0,0,0,0,T,153
160,Top Mid Lane Side ,nawwk,2,1,1,608,107,501,CT,153
161,Top Mid Lane Side ,nawwk,0,2,-2,15,219,-204,T,153
162,CT Outside Construction,nawwk,0,0,0,0,0,0,CT,153
163,CT Outside Construction,nawwk,0,0,0,0,0,0,T,153
164,Deep CT Peeking Towards B Site,nawwk,3,0,3,73,5,68,CT,153
165,Deep CT Peeking Towards B Site,nawwk,0,1,-1,0,30,-30,T,153
166,Pit,nawwk,0,1,-1,0,89,-89,CT,153
167,Pit,nawwk,0,0,0,0,0,0,T,153
168,Grill,nawwk,1,0,1,100,1,99,CT,153
169,Grill,nawwk,1,3,-2,181,152,29,T,153
170,Default Plant A Site,nawwk,1,1,0,39,100,-61,CT,153
171,Default Plant A Site,nawwk,3,3,0,259,254,5,T,153
172,Left Side Quadbox Peek for a CT,nawwk,0,0,0,0,0,0,CT,153
173,Left Side Quadbox Peek for a CT,nawwk,0,3,-3,0,174,-174,T,153
174,A Site,nawwk,2,1,1,151,27,124,CT,153
175,A Site,nawwk,0,1,-1,0,17,-17,T,153
176,B Site Cross for T's Exposed to CT and Quad,nawwk,2,0,2,139,0,139,CT,153
177,B Site Cross for T's Exposed to CT and Quad,nawwk,1,2,-1,28,179,-151,T,153
178,Library,nawwk,4,2,2,328,200,128,CT,153
179,Library,nawwk,2,0,2,114,60,54,T,153
180,Construction,nawwk,4,1,3,350,189,161,CT,153
181,Construction,nawwk,0,0,0,0,48,-48,T,153
182,1st Oranges,nawwk,1,1,0,100,44,56,CT,153
183,1st Oranges,nawwk,0,1,-1,87,100,-13,T,153
184,CT Spawn ,nawwk,0,1,-1,0,100,-100,CT,153
185,CT Spawn ,nawwk,0,0,0,0,0,0,T,153
186,Back Alley,nawwk,0,1,-1,16,100,-84,CT,153
187,Back Alley,nawwk,0,0,0,0,0,0,T,153
188,Right Side Quadbox Peek for a CT,nawwk,0,0,0,0,0,0,CT,153
189,Right Side Quadbox Peek for a CT,nawwk,0,0,0,0,0,0,T,153
190,Chokepoint Entrance onto A site from Library Side,nawwk,2,2,0,219,220,-1,CT,153
191,Chokepoint Entrance onto A site from Library Side,nawwk,0,0,0,0,0,0,T,153
192,Middle,nawwk,1,0,1,54,68,-14,CT,153
193,Middle,nawwk,0,0,0,34,142,-108,T,153
194,Front Coffins,nawwk,0,1,-1,15,100,-85,CT,153
195,Front Coffins,nawwk,2,1,1,200,39,161,T,153
196,A Site Behind Middle Boxes/Pillar hidden from Lane,nawwk,4,2,2,353,227,126,CT,153
197,A Site Behind Middle Boxes/Pillar hidden from Lane,nawwk,0,0,0,0,0,0,T,153
198,CT Banana Half Wall Side,nawwk,2,0,2,173,68,105,CT,153
199,CT Banana Half Wall Side,nawwk,2,1,1,119,29,90,T,153
200,Boiler Side Stairs,nawwk,1,1,0,139,93,46,CT,153
201,Boiler Side Stairs,nawwk,0,0,0,0,5,-5,T,153
202,Quad Box,nawwk,0,0,0,0,0,0,CT,153
203,Quad Box,nawwk,1,1,0,100,100,0,T,153
204,Top Balcony ,nawwk,0,0,0,0,1,-1,CT,153
205,Top Balcony ,nawwk,2,0,2,119,28,91,T,153
206,CT Banana Sandbags Right Corner,nawwk,0,0,0,0,0,0,CT,153
207,CT Banana Sandbags Right Corner,nawwk,1,0,1,16,45,-29,T,153
208,Logs,nawwk,0,0,0,0,0,0,CT,153
209,Logs,nawwk,1,0,1,90,0,90,T,153
210,Boiler Peek to Mid,nawwk,0,0,0,0,0,0,CT,153
211,Boiler Peek to Mid,nawwk,1,1,0,81,100,-19,T,153
212,Apps T Side Stairs,nawwk,3,2,1,234,134,100,CT,153
213,Apps T Side Stairs,nawwk,1,0,1,100,0,100,T,153
214,Apartments Hallway Peek from T Side,nawwk,0,0,0,0,0,0,CT,153
215,Apartments Hallway Peek from T Side,nawwk,0,0,0,0,0,0,T,153
216,CT Boost,nawwk,1,0,1,114,50,64,CT,153
217,CT Boost,nawwk,0,2,-2,0,92,-92,T,153
218,A Site Behind Default Boxes,nawwk,0,1,-1,0,100,-100,CT,153
219,A Site Behind Default Boxes,nawwk,0,0,0,0,0,0,T,153
220,SecondMid,nawwk,0,0,0,0,0,0,CT,153
221,SecondMid,nawwk,0,1,-1,68,100,-32,T,153
222,A Bombsite Back Site,nawwk,0,0,0,0,0,0,CT,153
223,A Bombsite Back Site,nawwk,1,1,0,22,19,3,T,153
224,Upstairs,nawwk,0,0,0,0,0,0,CT,153
225,Upstairs,nawwk,0,1,-1,0,76,-76,T,153
226,Deep Apps Past Hallway,nawwk,2,0,2,200,22,178,CT,153
227,Deep Apps Past Hallway,nawwk,1,0,1,100,0,100,T,153
228,Apartments,nawwk,0,0,0,0,0,0,CT,153
229,Apartments,nawwk,0,0,0,0,0,0,T,153
230,2nd Oranges,nawwk,1,1,0,50,156,-106,CT,153
231,2nd Oranges,nawwk,0,0,0,0,22,-22,T,153
232,Lane Peek Towards Top Mid,nawwk,1,0,1,0,0,0,CT,153
233,Lane Peek Towards Top Mid,nawwk,0,1,-1,0,18,-18,T,153
234,Top Hay Bales,nawwk,0,0,0,0,0,0,CT,153
235,Top Hay Bales,nawwk,1,0,1,97,89,8,T,153
236,CT Banana Barrels,nawwk,3,0,3,179,0,179,CT,153
237,CT Banana Barrels,nawwk,1,0,1,110,0,110,T,153
238,Balcony,nawwk,0,0,0,0,0,0,CT,153
239,Balcony,nawwk,0,1,-1,0,30,-30,T,153
240,Lane Behind Pillar,nawwk,0,0,0,0,0,0,CT,153
241,Lane Behind Pillar,nawwk,0,0,0,0,0,0,T,153
242,CT Outside Kitchen,nawwk,1,0,1,100,0,100,CT,153
243,CT Outside Kitchen,nawwk,0,0,0,0,0,0,T,153
244,CT Speed Way,nawwk,0,1,-1,72,100,-28,CT,153
245,CT Speed Way,nawwk,0,0,0,0,0,0,T,153
246,Bottom Mid Banana,nawwk,0,0,0,0,0,0,CT,153
247,Bottom Mid Banana,nawwk,0,0,0,0,19,-19,T,153
248,Arch Side CT Corner Peeking Towards Top Mid,nawwk,0,0,0,0,0,0,CT,153
249,Arch Side CT Corner Peeking Towards Top Mid,nawwk,0,0,0,0,0,0,T,153
250,Top Mid Arch Side,nawwk,1,1,0,55,100,-45,CT,153
251,Top Mid Arch Side,nawwk,0,0,0,0,0,0,T,153
252,Underpass,nawwk,0,0,0,0,0,0,CT,153
253,Underpass,nawwk,1,1,0,90,15,75,T,153
254,CT Arch,nawwk,0,0,0,0,34,-34,CT,153
255,CT Arch,nawwk,0,0,0,0,0,0,T,153
256,Bottom Mid exposed to Top Mid,nawwk,0,0,0,0,0,0,CT,153
257,Bottom Mid exposed to Top Mid,nawwk,0,0,0,0,18,-18,T,153
258,Pit Below Balcony,nawwk,0,0,0,0,0,0,CT,153
259,Pit Below Balcony,nawwk,1,0,1,100,0,100,T,153
260,Apps Hallway,nawwk,0,1,-1,0,100,-100,CT,153
261,Apps Hallway,nawwk,0,0,0,0,0,0,T,153
262,Top Mid Lane Side ,sh1r0,4,0,4,584,108,476,CT,160
263,Top Mid Lane Side ,sh1r0,1,4,-3,250,391,-141,T,160
264,CT Banana Half Wall Side,sh1r0,0,0,0,0,0,0,CT,160
265,CT Banana Half Wall Side,sh1r0,2,2,0,222,230,-8,T,160
266,B Site,sh1r0,0,1,-1,0,22,-22,CT,160
267,B Site,sh1r0,2,1,1,199,47,152,T,160
268,Lane Side,sh1r0,3,1,2,136,166,-30,CT,160
269,Lane Side,sh1r0,7,1,6,600,100,500,T,160
270,Banana,sh1r0,1,0,1,11,0,11,CT,160
271,Banana,sh1r0,2,3,-1,258,499,-241,T,160
272,CT Peek Towards B Choke,sh1r0,8,3,5,725,555,170,CT,160
273,CT Peek Towards B Choke,sh1r0,0,0,0,0,0,0,T,160
274,Arch Side,sh1r0,4,1,3,255,132,123,CT,160
275,Arch Side,sh1r0,1,1,0,100,71,29,T,160
276,Chokepoint Entering B,sh1r0,5,1,4,426,267,159,CT,160
277,Chokepoint Entering B,sh1r0,5,1,4,488,231,257,T,160
278,Grill,sh1r0,0,0,0,0,0,0,CT,160
279,Grill,sh1r0,2,2,0,175,85,90,T,160
280,Top Mid Arch Side,sh1r0,1,1,0,115,100,15,CT,160
281,Top Mid Arch Side,sh1r0,2,1,1,320,58,262,T,160
282,Front Coffins,sh1r0,0,1,-1,0,100,-100,CT,160
283,Front Coffins,sh1r0,0,0,0,0,34,-34,T,160
284,Top Mid Chokepoint,sh1r0,0,0,0,0,0,0,CT,160
285,Top Mid Chokepoint,sh1r0,4,1,3,315,109,206,T,160
286,B Site Cross for T's Exposed to CT and Quad,sh1r0,2,1,1,129,95,34,CT,160
287,B Site Cross for T's Exposed to CT and Quad,sh1r0,1,1,0,79,45,34,T,160
288,Behind Coffins Playing the B Site Cross,sh1r0,3,1,2,319,183,136,CT,160
289,Behind Coffins Playing the B Site Cross,sh1r0,0,0,0,0,0,0,T,160
290,A Bombsite Close Left,sh1r0,0,1,-1,0,27,-27,CT,160
291,A Bombsite Close Left,sh1r0,1,2,-1,56,200,-144,T,160
292,A Site Behind Default Boxes,sh1r0,1,1,0,39,100,-61,CT,160
293,A Site Behind Default Boxes,sh1r0,0,1,-1,0,82,-82,T,160
294,Right Side Quadbox Peek for a CT,sh1r0,2,0,2,122,0,122,CT,160
295,Right Side Quadbox Peek for a CT,sh1r0,1,2,-1,133,64,69,T,160
296,CT Banana Sandbangs,sh1r0,1,0,1,78,0,78,CT,160
297,CT Banana Sandbangs,sh1r0,0,1,-1,22,100,-78,T,160
298,CT Arch,sh1r0,1,1,0,100,100,0,CT,160
299,CT Arch,sh1r0,0,1,-1,47,142,-95,T,160
300,Middle,sh1r0,1,1,0,27,100,-73,CT,160
301,Middle,sh1r0,1,1,0,83,107,-24,T,160
302,SecondMid,sh1r0,0,0,0,0,0,0,CT,160
303,SecondMid,sh1r0,0,2,-2,0,200,-200,T,160
304,Dark,sh1r0,0,0,0,0,0,0,CT,160
305,Dark,sh1r0,0,0,0,0,47,-47,T,160
306,CT Banana Barrels,sh1r0,1,2,-1,100,248,-148,CT,160
307,CT Banana Barrels,sh1r0,1,0,1,100,0,100,T,160
308,Chokepoint Entrance onto A site from Library Side,sh1r0,2,1,1,182,127,55,CT,160
309,Chokepoint Entrance onto A site from Library Side,sh1r0,0,0,0,0,0,0,T,160
310,T Ramp Peeking Towards Mid,sh1r0,0,1,-1,0,100,-100,CT,160
311,T Ramp Peeking Towards Mid,sh1r0,3,1,2,293,251,42,T,160
312,TopofMid,sh1r0,0,2,-2,0,200,-200,CT,160
313,TopofMid,sh1r0,0,0,0,0,0,0,T,160
314,A Site Behind Middle Boxes/Pillar hidden from Lane,sh1r0,0,2,-2,41,192,-151,CT,160
315,A Site Behind Middle Boxes/Pillar hidden from Lane,sh1r0,0,0,0,0,0,0,T,160
316,CT Banana Sandbags Right Corner,sh1r0,0,0,0,0,0,0,CT,160
317,CT Banana Sandbags Right Corner,sh1r0,0,2,-2,0,121,-121,T,160
318,Deep CT Peeking Towards B Site,sh1r0,3,3,0,495,300,195,CT,160
319,Deep CT Peeking Towards B Site,sh1r0,0,0,0,0,0,0,T,160
320,CT Boost,sh1r0,0,1,-1,21,103,-82,CT,160
321,CT Boost,sh1r0,0,0,0,0,0,0,T,160
322,1st Oranges,sh1r0,0,1,-1,0,60,-60,CT,160
323,1st Oranges,sh1r0,0,0,0,0,0,0,T,160
324,CT Outside Kitchen,sh1r0,2,1,1,174,100,74,CT,160
325,CT Outside Kitchen,sh1r0,0,0,0,0,0,0,T,160
326,Pit Peek Towards Lane,sh1r0,0,0,0,0,0,0,CT,160
327,Pit Peek Towards Lane,sh1r0,1,1,0,82,100,-18,T,160
328,Lane Behind Pillar,sh1r0,1,0,1,100,0,100,CT,160
329,Lane Behind Pillar,sh1r0,0,0,0,0,0,0,T,160
330,Apps T Side Stairs,sh1r0,0,0,0,0,0,0,CT,160
331,Apps T Side Stairs,sh1r0,0,0,0,0,8,-8,T,160
332,Default Plant A Site,sh1r0,0,0,0,0,0,0,CT,160
333,Default Plant A Site,sh1r0,0,2,-2,77,200,-123,T,160
334,Underpass,sh1r0,0,0,0,0,0,0,CT,160
335,Underpass,sh1r0,2,1,1,326,100,226,T,160
336,Logs,sh1r0,1,0,1,100,0,100,CT,160
337,Logs,sh1r0,0,1,-1,128,120,8,T,160
338,Quad Box,sh1r0,5,1,4,391,200,191,CT,160
339,Quad Box,sh1r0,3,0,3,393,134,259,T,160
340,Top Balcony ,sh1r0,1,0,1,100,8,92,CT,160
341,Top Balcony ,sh1r0,1,0,1,43,0,43,T,160
342,2nd Oranges,sh1r0,0,1,-1,127,37,90,CT,160
343,2nd Oranges,sh1r0,2,0,2,155,63,92,T,160
344,Left Side Quadbox Peek for a CT,sh1r0,1,2,-1,64,84,-20,CT,160
345,Left Side Quadbox Peek for a CT,sh1r0,0,0,0,48,0,48,T,160
346,A Site,sh1r0,1,0,1,145,0,145,CT,160
347,A Site,sh1r0,0,0,0,89,81,8,T,160
348,Library,sh1r0,8,1,7,791,146,645,CT,160
349,Library,sh1r0,0,0,0,0,0,0,T,160
350,A Site Left Side Middle Boxes,sh1r0,0,0,0,0,0,0,CT,160
351,A Site Left Side Middle Boxes,sh1r0,0,1,-1,0,34,-34,T,160
352,Connector,sh1r0,0,0,0,0,0,0,CT,160
353,Connector,sh1r0,0,1,-1,0,29,-29,T,160
354,Apartments Hallway Peek from T Side,sh1r0,0,0,0,0,0,0,CT,160
355,Apartments Hallway Peek from T Side,sh1r0,0,0,0,0,0,0,T,160
356,CTBar,sh1r0,0,1,-1,0,38,-38,CT,160
357,CTBar,sh1r0,0,0,0,0,0,0,T,160
358,A Site Right Side Middle Pillar,sh1r0,0,0,0,0,0,0,CT,160
359,A Site Right Side Middle Pillar,sh1r0,1,0,1,56,0,56,T,160
360,Back Alley,sh1r0,0,0,0,0,0,0,CT,160
361,Back Alley,sh1r0,0,1,-1,10,146,-136,T,160
362,CT Tree,sh1r0,1,0,1,75,0,75,CT,160
363,CT Tree,sh1r0,0,0,0,0,0,0,T,160
364,Pit,sh1r0,0,0,0,49,0,49,CT,160
365,Pit,sh1r0,0,1,-1,0,100,-100,T,160
366,Boiler Side Stairs,sh1r0,0,0,0,0,0,0,CT,160
367,Boiler Side Stairs,sh1r0,0,0,0,2,0,2,T,160
368,Pit Below Balcony,sh1r0,0,0,0,0,0,0,CT,160
369,Pit Below Balcony,sh1r0,0,0,0,0,0,0,T,160
370,CT Outside Construction,sh1r0,1,1,0,12,22,-10,CT,160
371,CT Outside Construction,sh1r0,0,0,0,0,0,0,T,160
372,Outside Library,sh1r0,1,1,0,100,73,27,CT,160
373,Outside Library,sh1r0,0,0,0,0,0,0,T,160
374,Deep Apps Past Hallway,sh1r0,1,0,1,100,0,100,CT,160
375,Deep Apps Past Hallway,sh1r0,1,1,0,64,102,-38,T,160
376,Construction,sh1r0,3,0,3,347,86,261,CT,160
377,Construction,sh1r0,0,0,0,0,0,0,T,160
378,Bottom Mid Banana,sh1r0,0,0,0,0,0,0,CT,160
379,Bottom Mid Banana,sh1r0,0,0,0,22,0,22,T,160
380,Graveyard Stairs,sh1r0,0,0,0,0,0,0,CT,160
381,Graveyard Stairs,sh1r0,0,0,0,0,0,0,T,160
382,CT Outside Arch,sh1r0,0,0,0,0,0,0,CT,160
383,CT Outside Arch,sh1r0,0,0,0,0,0,0,T,160
384,Top Coffins,sh1r0,1,1,0,100,73,27,CT,160
385,Top Coffins,sh1r0,0,0,0,0,0,0,T,160
386,A Bombsite Back Site,sh1r0,0,0,0,0,0,0,CT,160
387,A Bombsite Back Site,sh1r0,0,0,0,68,81,-13,T,160
388,LowerMid,sh1r0,0,0,0,0,8,-8,CT,160
389,LowerMid,sh1r0,0,0,0,36,0,36,T,160
390,Chokepoint Entering B,nafany,3,3,0,439,320,119,CT,160
391,Chokepoint Entering B,nafany,4,4,0,327,361,-34,T,160
392,Top Mid Arch Side,nafany,7,3,4,619,405,214,CT,160
393,Top Mid Arch Side,nafany,2,6,-4,189,807,-618,T,160
394,CT Banana Half Wall Side,nafany,0,3,-3,576,361,215,CT,160
395,CT Banana Half Wall Side,nafany,1,6,-5,349,573,-224,T,160
396,CT Peek Towards B Choke,nafany,5,4,1,427,568,-141,CT,160
397,CT Peek Towards B Choke,nafany,1,1,0,213,98,115,T,160
398,Grill,nafany,0,0,0,0,0,0,CT,160
399,Grill,nafany,1,2,-1,87,214,-127,T,160
400,Top Mid Lane Side ,nafany,0,1,-1,0,57,-57,CT,160
401,Top Mid Lane Side ,nafany,2,1,1,190,201,-11,T,160
402,Banana,nafany,1,1,0,9,131,-122,CT,160
403,Banana,nafany,2,4,-2,263,455,-192,T,160
404,Middle,nafany,3,1,2,201,120,81,CT,160
405,Middle,nafany,0,3,-3,10,327,-317,T,160
406,B Site Cross for T's Exposed to CT and Quad,nafany,2,2,0,108,200,-92,CT,160
407,B Site Cross for T's Exposed to CT and Quad,nafany,1,0,1,15,0,15,T,160
408,B Site,nafany,1,2,-1,262,203,59,CT,160
409,B Site,nafany,0,1,-1,0,100,-100,T,160
410,Quad Box,nafany,6,6,0,592,608,-16,CT,160
411,Quad Box,nafany,0,0,0,0,0,0,T,160
412,Lane Side,nafany,1,2,-1,53,197,-144,CT,160
413,Lane Side,nafany,2,1,1,160,100,60,T,160
414,Arch Side,nafany,3,3,0,229,314,-85,CT,160
415,Arch Side,nafany,1,0,1,81,202,-121,T,160
416,Outside Library,nafany,1,0,1,88,26,62,CT,160
417,Outside Library,nafany,4,2,2,403,254,149,T,160
418,A Site,nafany,1,1,0,136,100,36,CT,160
419,A Site,nafany,2,0,2,209,76,133,T,160
420,Top Hay Bales,nafany,0,0,0,0,0,0,CT,160
421,Top Hay Bales,nafany,1,0,1,100,0,100,T,160
422,Library,nafany,1,2,-1,163,236,-73,CT,160
423,Library,nafany,2,0,2,148,16,132,T,160
424,CT Arch,nafany,2,1,1,239,100,139,CT,160
425,CT Arch,nafany,0,2,-2,48,135,-87,T,160
426,Deep CT Peeking Towards B Site,nafany,0,0,0,0,0,0,CT,160
427,Deep CT Peeking Towards B Site,nafany,1,0,1,100,0,100,T,160
428,1st Oranges,nafany,3,1,2,353,113,240,CT,160
429,1st Oranges,nafany,1,0,1,49,0,49,T,160
430,CT Boost,nafany,0,1,-1,99,69,30,CT,160
431,CT Boost,nafany,0,1,-1,0,90,-90,T,160
432,CT Spawn ,nafany,0,0,0,0,0,0,CT,160
433,CT Spawn ,nafany,1,2,-1,100,178,-78,T,160
434,T Ramp Peeking Towards Mid,nafany,0,0,0,0,0,0,CT,160
435,T Ramp Peeking Towards Mid,nafany,1,0,1,100,111,-11,T,160
436,CT Banana Sandbangs,nafany,4,2,2,543,374,169,CT,160
437,CT Banana Sandbangs,nafany,1,0,1,100,21,79,T,160
438,A Bombsite Close Left,nafany,1,0,1,37,0,37,CT,160
439,A Bombsite Close Left,nafany,2,0,2,141,70,71,T,160
440,Back Alley,nafany,1,1,0,100,100,0,CT,160
441,Back Alley,nafany,0,1,-1,0,100,-100,T,160
442,Front Coffins,nafany,0,0,0,0,0,0,CT,160
443,Front Coffins,nafany,0,1,-1,34,74,-40,T,160
444,Left Side Quadbox Peek for a CT,nafany,1,2,-1,94,200,-106,CT,160
445,Left Side Quadbox Peek for a CT,nafany,0,0,0,0,0,0,T,160
446,A Site Right Side Middle Pillar,nafany,0,0,0,0,0,0,CT,160
447,A Site Right Side Middle Pillar,nafany,0,1,-1,0,12,-12,T,160
448,Arch Side Cubby,nafany,1,1,0,109,122,-13,CT,160
449,Arch Side Cubby,nafany,0,1,-1,36,73,-37,T,160
450,Chokepoint Entrance onto A site from Library Side,nafany,1,1,0,204,189,15,CT,160
451,Chokepoint Entrance onto A site from Library Side,nafany,0,0,0,54,0,54,T,160
452,A Site Behind Default Boxes,nafany,0,0,0,48,0,48,CT,160
453,A Site Behind Default Boxes,nafany,0,0,0,0,0,0,T,160
454,CT Outside Construction,nafany,0,2,-2,26,105,-79,CT,160
455,CT Outside Construction,nafany,0,0,0,2,0,2,T,160
456,A Bombsite Back Site,nafany,0,1,-1,0,100,-100,CT,160
457,A Bombsite Back Site,nafany,0,0,0,0,0,0,T,160
458,Default Plant A Site,nafany,0,0,0,60,0,60,CT,160
459,Default Plant A Site,nafany,0,1,-1,0,1,-1,T,160
460,Behind Coffins Playing the B Site Cross,nafany,1,0,1,110,34,76,CT,160
461,Behind Coffins Playing the B Site Cross,nafany,0,1,-1,0,65,-65,T,160
462,2nd Oranges,nafany,3,2,1,275,217,58,CT,160
463,2nd Oranges,nafany,1,0,1,100,0,100,T,160
464,CT Banana Barrels,nafany,0,0,0,0,0,0,CT,160
465,CT Banana Barrels,nafany,1,1,0,126,83,43,T,160
466,Dark,nafany,3,1,2,242,200,42,CT,160
467,Dark,nafany,2,0,2,102,44,58,T,160
468,Pit,nafany,0,0,0,0,0,0,CT,160
469,Pit,nafany,0,0,0,0,0,0,T,160
470,Balcony,nafany,0,0,0,0,0,0,CT,160
471,Balcony,nafany,1,1,0,127,112,15,T,160
472,CT Outside Kitchen,nafany,0,0,0,1,0,1,CT,160
473,CT Outside Kitchen,nafany,0,1,-1,0,100,-100,T,160
474,Top Balcony ,nafany,1,0,1,10,0,10,CT,160
475,Top Balcony ,nafany,1,0,1,100,0,100,T,160
476,Boiler Peek to Mid,nafany,0,0,0,0,0,0,CT,160
477,Boiler Peek to Mid,nafany,0,1,-1,0,40,-40,T,160
478,CT Speed Way,nafany,0,1,-1,0,100,-100,CT,160
479,CT Speed Way,nafany,0,0,0,0,0,0,T,160
480,A Site Behind Middle Boxes/Pillar hidden from Lane,nafany,0,0,0,0,0,0,CT,160
481,A Site Behind Middle Boxes/Pillar hidden from Lane,nafany,0,0,0,0,0,0,T,160
482,CT Tree,nafany,0,1,-1,10,75,-65,CT,160
483,CT Tree,nafany,0,0,0,0,0,0,T,160
484,CT Banana Sandbags Right Corner,nafany,0,0,0,0,0,0,CT,160
485,CT Banana Sandbags Right Corner,nafany,1,0,1,100,0,100,T,160
486,Bottom Mid exposed to Top Mid,nafany,1,0,1,100,0,100,CT,160
487,Bottom Mid exposed to Top Mid,nafany,0,1,-1,0,90,-90,T,160
488,Deep Apps Past Hallway,nafany,0,0,0,0,0,0,CT,160
489,Deep Apps Past Hallway,nafany,0,1,-1,0,100,-100,T,160
490,LowerMid,nafany,0,0,0,0,0,0,CT,160
491,LowerMid,nafany,0,0,0,0,0,0,T,160
492,Top Mid Chokepoint,nafany,0,0,0,24,0,24,CT,160
493,Top Mid Chokepoint,nafany,0,1,-1,100,161,-61,T,160
494,Boiler Side Stairs,nafany,0,0,0,33,0,33,CT,160
495,Boiler Side Stairs,nafany,0,0,0,0,0,0,T,160
496,SecondMid,nafany,0,0,0,0,0,0,CT,160
497,SecondMid,nafany,3,1,2,227,164,63,T,160
498,Pit Below Balcony,nafany,0,0,0,0,0,0,CT,160
499,Pit Below Balcony,nafany,0,0,0,0,0,0,T,160
500,Right Side Quadbox Peek for a CT,nafany,6,1,5,392,135,257,CT,160
501,Right Side Quadbox Peek for a CT,nafany,0,0,0,0,0,0,T,160
502,Top Coffins,nafany,0,0,0,0,0,0,CT,160
503,Top Coffins,nafany,0,0,0,0,0,0,T,160
504,Underpass,nafany,0,0,0,0,0,0,CT,160
505,Underpass,nafany,1,1,0,82,173,-91,T,160
506,Logs,nafany,0,0,0,0,0,0,CT,160
507,Logs,nafany,1,0,1,105,49,56,T,160
508,CT Banana Close Left Half Wall,nafany,1,0,1,36,37,-1,CT,160
509,CT Banana Close Left Half Wall,nafany,0,0,0,0,0,0,T,160
510,Top Graveyard,nafany,1,0,1,96,0,96,CT,160
511,Top Graveyard,nafany,1,1,0,46,7,39,T,160
512,Apps T Side Stairs,nafany,0,0,0,0,1,-1,CT,160
513,Apps T Side Stairs,nafany,0,0,0,97,10,87,T,160
514,Banana,Hobbit,1,1,0,72,100,-28,CT,160
515,Banana,Hobbit,3,15,-12,616,1613,-997,T,160
516,Chokepoint Entering B,Hobbit,5,5,0,704,705,-1,CT,160
517,Chokepoint Entering B,Hobbit,2,4,-2,292,285,7,T,160
518,CT Banana Sandbangs,Hobbit,6,6,0,816,571,245,CT,160
519,CT Banana Sandbangs,Hobbit,2,2,0,254,156,98,T,160
520,CT Banana Half Wall Side,Hobbit,1,2,-1,387,221,166,CT,160
521,CT Banana Half Wall Side,Hobbit,2,2,0,197,298,-101,T,160
522,Grill,Hobbit,1,1,0,72,112,-40,CT,160
523,Grill,Hobbit,0,1,-1,11,100,-89,T,160
524,B Site,Hobbit,2,1,1,120,182,-62,CT,160
525,B Site,Hobbit,2,1,1,54,73,-19,T,160
526,Logs,Hobbit,0,0,0,0,0,0,CT,160
527,Logs,Hobbit,2,4,-2,305,391,-86,T,160
528,B Site Cross for T's Exposed to CT and Quad,Hobbit,0,0,0,58,10,48,CT,160
529,B Site Cross for T's Exposed to CT and Quad,Hobbit,0,1,-1,22,95,-73,T,160
530,CT Peek Towards B Choke,Hobbit,5,3,2,968,388,580,CT,160
531,CT Peek Towards B Choke,Hobbit,0,1,-1,0,77,-77,T,160
532,Behind Coffins Playing the B Site Cross,Hobbit,1,5,-4,282,475,-193,CT,160
533,Behind Coffins Playing the B Site Cross,Hobbit,0,0,0,0,0,0,T,160
534,1st Oranges,Hobbit,2,2,0,474,200,274,CT,160
535,1st Oranges,Hobbit,0,0,0,0,0,0,T,160
536,T Ramp Peeking Towards Mid,Hobbit,0,0,0,0,0,0,CT,160
537,T Ramp Peeking Towards Mid,Hobbit,0,2,-2,106,393,-287,T,160
538,Lane Side,Hobbit,1,0,1,76,0,76,CT,160
539,Lane Side,Hobbit,0,1,-1,36,39,-3,T,160
540,Front Coffins,Hobbit,0,1,-1,0,63,-63,CT,160
541,Front Coffins,Hobbit,0,0,0,0,0,0,T,160
542,Top Coffins,Hobbit,15,4,11,1366,460,906,CT,160
543,Top Coffins,Hobbit,0,0,0,0,0,0,T,160
544,Top Mid Arch Side,Hobbit,0,1,-1,45,100,-55,CT,160
545,Top Mid Arch Side,Hobbit,0,1,-1,27,54,-27,T,160
546,Top Balcony ,Hobbit,0,0,0,25,61,-36,CT,160
547,Top Balcony ,Hobbit,0,1,-1,20,100,-80,T,160
548,Arch Side,Hobbit,0,0,0,0,0,0,CT,160
549,Arch Side,Hobbit,1,1,0,73,87,-14,T,160
550,Pit Below Balcony,Hobbit,0,0,0,0,0,0,CT,160
551,Pit Below Balcony,Hobbit,1,2,-1,161,149,12,T,160
552,Bottom Mid Banana,Hobbit,2,1,1,150,100,50,CT,160
553,Bottom Mid Banana,Hobbit,0,1,-1,131,316,-185,T,160
554,CT Banana Barrels,Hobbit,1,1,0,168,79,89,CT,160
555,CT Banana Barrels,Hobbit,0,0,0,0,0,0,T,160
556,Deep Apps Past Hallway,Hobbit,3,0,3,284,0,284,CT,160
557,Deep Apps Past Hallway,Hobbit,0,1,-1,0,100,-100,T,160
558,Next to Library Cubby,Hobbit,0,1,-1,0,100,-100,CT,160
559,Next to Library Cubby,Hobbit,0,1,-1,0,53,-53,T,160
560,CT Near Well,Hobbit,0,0,0,0,0,0,CT,160
561,CT Near Well,Hobbit,1,0,1,100,49,51,T,160
562,CT Outside Construction,Hobbit,0,0,0,250,5,245,CT,160
563,CT Outside Construction,Hobbit,0,0,0,0,0,0,T,160
564,Apps Hallway,Hobbit,0,0,0,0,0,0,CT,160
565,Apps Hallway,Hobbit,0,1,-1,0,33,-33,T,160
566,Pit Peek Towards Lane,Hobbit,0,0,0,0,0,0,CT,160
567,Pit Peek Towards Lane,Hobbit,0,0,0,0,0,0,T,160
568,Quad Box,Hobbit,1,1,0,257,100,157,CT,160
569,Quad Box,Hobbit,0,0,0,0,0,0,T,160
570,CT Boost,Hobbit,1,0,1,173,38,135,CT,160
571,CT Boost,Hobbit,0,0,0,0,0,0,T,160
572,A Site,Hobbit,2,0,2,123,0,123,CT,160
573,A Site,Hobbit,0,2,-2,0,8,-8,T,160
574,CT Outside Arch,Hobbit,1,1,0,6,8,-2,CT,160
575,CT Outside Arch,Hobbit,0,0,0,0,0,0,T,160
576,Left Side Quadbox Peek for a CT,Hobbit,0,1,-1,155,100,55,CT,160
577,Left Side Quadbox Peek for a CT,Hobbit,0,0,0,0,0,0,T,160
578,Bottom Mid exposed to Top Mid,Hobbit,0,0,0,0,0,0,CT,160
579,Bottom Mid exposed to Top Mid,Hobbit,2,1,1,185,169,16,T,160
580,Deep CT Peeking Towards B Site,Hobbit,3,1,2,252,100,152,CT,160
581,Deep CT Peeking Towards B Site,Hobbit,0,0,0,0,0,0,T,160
582,CT Banana Sandbags Right Corner,Hobbit,1,0,1,80,25,55,CT,160
583,CT Banana Sandbags Right Corner,Hobbit,1,0,1,100,54,46,T,160
584,2nd Oranges,Hobbit,4,1,3,426,189,237,CT,160
585,2nd Oranges,Hobbit,0,0,0,0,0,0,T,160
586,Top Mid Lane Side ,Hobbit,1,0,1,80,14,66,CT,160
587,Top Mid Lane Side ,Hobbit,0,2,-2,21,127,-106,T,160
588,A Bombsite Close Left,Hobbit,1,1,0,94,124,-30,CT,160
589,A Bombsite Close Left,Hobbit,1,0,1,23,0,23,T,160
590,Balcony,Hobbit,0,1,-1,0,41,-41,CT,160
591,Balcony,Hobbit,0,0,0,0,26,-26,T,160
592,Apartments Hallway Peek from T Side,Hobbit,0,0,0,0,0,0,CT,160
593,Apartments Hallway Peek from T Side,Hobbit,0,1,-1,11,100,-89,T,160
594,A Bombsite Back Site,Hobbit,0,0,0,0,0,0,CT,160
595,A Bombsite Back Site,Hobbit,0,0,0,0,59,-59,T,160
596,Top Mid Chokepoint,Hobbit,0,0,0,0,0,0,CT,160
597,Top Mid Chokepoint,Hobbit,0,1,-1,0,100,-100,T,160
598,Default Plant A Site,Hobbit,0,0,0,0,0,0,CT,160
599,Default Plant A Site,Hobbit,0,0,0,0,98,-98,T,160
600,Dark,Hobbit,5,1,4,506,187,319,CT,160
601,Dark,Hobbit,1,0,1,114,34,80,T,160
602,Apps T Side Stairs,Hobbit,0,0,0,0,6,-6,CT,160
603,Apps T Side Stairs,Hobbit,0,0,0,0,0,0,T,160
604,Middle,Hobbit,0,0,0,0,0,0,CT,160
605,Middle,Hobbit,1,0,1,100,62,38,T,160
606,CT Outside Kitchen,Hobbit,0,0,0,0,0,0,CT,160
607,CT Outside Kitchen,Hobbit,0,0,0,0,0,0,T,160
608,A Site Right Side Middle Pillar,Hobbit,0,0,0,0,0,0,CT,160
609,A Site Right Side Middle Pillar,Hobbit,0,0,0,0,0,0,T,160
610,Construction,Hobbit,1,1,0,96,106,-10,CT,160
611,Construction,Hobbit,0,0,0,0,0,0,T,160
612,Library,Hobbit,1,1,0,189,23,166,CT,160
613,Library,Hobbit,0,0,0,0,0,0,T,160
614,CT Arch,Hobbit,0,0,0,0,0,0,CT,160
615,CT Arch,Hobbit,0,0,0,0,0,0,T,160
616,Graveyard Stairs,Hobbit,0,0,0,0,0,0,CT,160
617,Graveyard Stairs,Hobbit,0,0,0,0,0,0,T,160
618,Boiler Room,Hobbit,0,0,0,0,0,0,CT,160
619,Boiler Room,Hobbit,0,1,-1,0,100,-100,T,160
620,Behind B Site Back Pillar,Hobbit,0,0,0,0,0,0,CT,160
621,Behind B Site Back Pillar,Hobbit,0,0,0,0,0,0,T,160
622,Chokepoint Entrance onto A site from Library Side,Hobbit,1,0,1,66,82,-16,CT,160
623,Chokepoint Entrance onto A site from Library Side,Hobbit,0,0,0,0,0,0,T,160
624,Top Hay Bales,Hobbit,0,0,0,0,0,0,CT,160
625,Top Hay Bales,Hobbit,0,0,0,0,35,-35,T,160
626,Boiler Side Stairs,Hobbit,0,0,0,0,0,0,CT,160
627,Boiler Side Stairs,Hobbit,0,0,0,0,0,0,T,160
628,Banana,YEKINDAR,10,4,6,807,547,260,CT,141
629,Banana,YEKINDAR,4,5,-1,358,623,-265,T,141
630,Chokepoint Entering B,YEKINDAR,3,3,0,293,244,49,CT,141
631,Chokepoint Entering B,YEKINDAR,2,4,-2,121,424,-303,T,141
632,CT Banana Half Wall Side,YEKINDAR,9,4,5,1174,678,496,CT,141
633,CT Banana Half Wall Side,YEKINDAR,2,1,1,224,147,77,T,141
634,Lane Side,YEKINDAR,0,0,0,0,0,0,CT,141
635,Lane Side,YEKINDAR,1,4,-3,243,282,-39,T,141
636,B Site,YEKINDAR,1,2,-1,127,198,-71,CT,141
637,B Site,YEKINDAR,0,3,-3,0,223,-223,T,141
638,Middle,YEKINDAR,0,2,-2,26,168,-142,CT,141
639,Middle,YEKINDAR,1,2,-1,122,116,6,T,141
640,Bottom Mid exposed to Top Mid,YEKINDAR,7,3,4,737,300,437,CT,141
641,Bottom Mid exposed to Top Mid,YEKINDAR,0,2,-2,0,203,-203,T,141
642,Top Mid Lane Side ,YEKINDAR,2,1,1,106,56,50,CT,141
643,Top Mid Lane Side ,YEKINDAR,1,4,-3,161,290,-129,T,141
644,Top Mid Chokepoint,YEKINDAR,0,0,0,0,0,0,CT,141
645,Top Mid Chokepoint,YEKINDAR,0,0,0,89,88,1,T,141
646,Logs,YEKINDAR,3,0,3,284,27,257,CT,141
647,Logs,YEKINDAR,1,1,0,193,116,77,T,141
648,Top Mid Arch Side,YEKINDAR,0,1,-1,81,111,-30,CT,141
649,Top Mid Arch Side,YEKINDAR,1,4,-3,124,412,-288,T,141
650,A Site,YEKINDAR,0,2,-2,81,193,-112,CT,141
651,A Site,YEKINDAR,1,1,0,75,65,10,T,141
652,CT Peek Towards B Choke,YEKINDAR,3,1,2,290,162,128,CT,141
653,CT Peek Towards B Choke,YEKINDAR,0,2,-2,108,183,-75,T,141
654,Library,YEKINDAR,0,2,-2,79,126,-47,CT,141
655,Library,YEKINDAR,2,2,0,239,240,-1,T,141
656,Top Balcony ,YEKINDAR,0,1,-1,0,97,-97,CT,141
657,Top Balcony ,YEKINDAR,1,1,0,98,127,-29,T,141
658,Grill,YEKINDAR,0,0,0,0,0,0,CT,141
659,Grill,YEKINDAR,0,2,-2,54,265,-211,T,141
660,Pit Below Balcony,YEKINDAR,0,0,0,0,0,0,CT,141
661,Pit Below Balcony,YEKINDAR,1,1,0,125,41,84,T,141
662,T Ramp Peeking Towards Mid,YEKINDAR,0,1,-1,45,100,-55,CT,141
663,T Ramp Peeking Towards Mid,YEKINDAR,0,0,0,0,112,-112,T,141
664,Chokepoint Entrance onto A site from Library Side,YEKINDAR,0,0,0,0,0,0,CT,141
665,Chokepoint Entrance onto A site from Library Side,YEKINDAR,0,1,-1,0,100,-100,T,141
666,B Site Cross for T's Exposed to CT and Quad,YEKINDAR,0,0,0,0,0,0,CT,141
667,B Site Cross for T's Exposed to CT and Quad,YEKINDAR,3,2,1,273,288,-15,T,141
668,Behind Coffins Playing the B Site Cross,YEKINDAR,1,2,-1,259,136,123,CT,141
669,Behind Coffins Playing the B Site Cross,YEKINDAR,0,0,0,0,0,0,T,141
670,Arch Side,YEKINDAR,1,0,1,68,29,39,CT,141
671,Arch Side,YEKINDAR,0,1,-1,95,100,-5,T,141
672,Apps T Side Stairs,YEKINDAR,0,0,0,0,0,0,CT,141
673,Apps T Side Stairs,YEKINDAR,0,1,-1,0,100,-100,T,141
674,CT Outside Kitchen,YEKINDAR,1,2,-1,150,157,-7,CT,141
675,CT Outside Kitchen,YEKINDAR,0,0,0,0,0,0,T,141
676,SecondMid,YEKINDAR,3,0,3,186,112,74,CT,141
677,SecondMid,YEKINDAR,0,2,-2,108,200,-92,T,141
678,Pit,YEKINDAR,1,0,1,97,0,97,CT,141
679,Pit,YEKINDAR,2,2,0,265,197,68,T,141
680,A Site Behind Middle Boxes/Pillar hidden from Lane,YEKINDAR,0,0,0,49,0,49,CT,141
681,A Site Behind Middle Boxes/Pillar hidden from Lane,YEKINDAR,0,0,0,0,0,0,T,141
682,Top Coffins,YEKINDAR,2,0,2,144,25,119,CT,141
683,Top Coffins,YEKINDAR,0,0,0,0,0,0,T,141
684,Top Graveyard,YEKINDAR,0,0,0,0,0,0,CT,141
685,Top Graveyard,YEKINDAR,0,1,-1,27,100,-73,T,141
686,CT Banana Sandbangs,YEKINDAR,5,2,3,534,249,285,CT,141
687,CT Banana Sandbangs,YEKINDAR,3,0,3,315,142,173,T,141
688,A Site Left Side Middle Boxes,YEKINDAR,0,2,-2,54,191,-137,CT,141
689,A Site Left Side Middle Boxes,YEKINDAR,1,0,1,51,0,51,T,141
690,Front Coffins,YEKINDAR,0,0,0,0,0,0,CT,141
691,Front Coffins,YEKINDAR,1,2,-1,52,144,-92,T,141
692,Lane Behind Pillar,YEKINDAR,0,0,0,27,0,27,CT,141
693,Lane Behind Pillar,YEKINDAR,2,1,1,138,114,24,T,141
694,TopofMid,YEKINDAR,0,0,0,0,0,0,CT,141
695,TopofMid,YEKINDAR,0,1,-1,0,100,-100,T,141
696,Default Plant A Site,YEKINDAR,0,0,0,0,0,0,CT,141
697,Default Plant A Site,YEKINDAR,0,1,-1,0,55,-55,T,141
698,Left Side Quadbox Peek for a CT,YEKINDAR,0,1,-1,0,100,-100,CT,141
699,Left Side Quadbox Peek for a CT,YEKINDAR,0,0,0,0,0,0,T,141
700,Quad Box,YEKINDAR,0,0,0,0,0,0,CT,141
701,Quad Box,YEKINDAR,1,1,0,100,6,94,T,141
702,Dark,YEKINDAR,0,0,0,0,0,0,CT,141
703,Dark,YEKINDAR,0,0,0,0,0,0,T,141
704,CT Tree,YEKINDAR,0,0,0,0,0,0,CT,141
705,CT Tree,YEKINDAR,0,0,0,0,0,0,T,141
706,Apartments,YEKINDAR,0,0,0,0,49,-49,CT,141
707,Apartments,YEKINDAR,0,0,0,34,1,33,T,141
708,Graveyard Stairs,YEKINDAR,0,0,0,0,0,0,CT,141
709,Graveyard Stairs,YEKINDAR,0,0,0,0,0,0,T,141
710,Bottom Mid Banana,YEKINDAR,2,0,2,149,0,149,CT,141
711,Bottom Mid Banana,YEKINDAR,0,0,0,0,27,-27,T,141
712,1st Oranges,YEKINDAR,0,1,-1,97,100,-3,CT,141
713,1st Oranges,YEKINDAR,0,0,0,0,0,0,T,141
714,CT Boost,YEKINDAR,0,0,0,0,0,0,CT,141
715,CT Boost,YEKINDAR,0,0,0,0,0,0,T,141
716,Right Side Quadbox Peek for a CT,YEKINDAR,1,1,0,121,50,71,CT,141
717,Right Side Quadbox Peek for a CT,YEKINDAR,0,0,0,0,0,0,T,141
718,Outside Library,YEKINDAR,1,0,1,5,52,-47,CT,141
719,Outside Library,YEKINDAR,1,1,0,151,68,83,T,141
720,CT Banana Barrels,YEKINDAR,1,0,1,77,8,69,CT,141
721,CT Banana Barrels,YEKINDAR,0,0,0,0,0,0,T,141
722,A Bombsite Close Left,YEKINDAR,0,0,0,0,0,0,CT,141
723,A Bombsite Close Left,YEKINDAR,0,0,0,0,0,0,T,141
724,Deep Apps Past Hallway,YEKINDAR,0,0,0,0,0,0,CT,141
725,Deep Apps Past Hallway,YEKINDAR,0,1,-1,0,100,-100,T,141
726,CT Spawn ,YEKINDAR,0,0,0,0,0,0,CT,141
727,CT Spawn ,YEKINDAR,0,0,0,21,0,21,T,141
728,CT Outside Arch,YEKINDAR,0,0,0,0,0,0,CT,141
729,CT Outside Arch,YEKINDAR,0,0,0,0,0,0,T,141
730,A Site Behind Default Boxes,YEKINDAR,1,0,1,126,0,126,CT,141
731,A Site Behind Default Boxes,YEKINDAR,0,0,0,0,0,0,T,141
732,Back Alley,YEKINDAR,0,1,-1,82,100,-18,CT,141
733,Back Alley,YEKINDAR,0,0,0,0,0,0,T,141
734,Banana,oBo,2,1,1,340,171,169,CT,138
735,Banana,oBo,3,5,-2,491,1213,-722,T,138
736,Arch Side,oBo,3,5,-2,315,541,-226,CT,138
737,Arch Side,oBo,2,1,1,141,99,42,T,138
738,Chokepoint Entering B,oBo,2,2,0,351,204,147,CT,138
739,Chokepoint Entering B,oBo,5,4,1,472,539,-67,T,138
740,Top Balcony ,oBo,1,3,-2,144,300,-156,CT,138
741,Top Balcony ,oBo,1,3,-2,137,138,-1,T,138
742,CT Peek Towards B Choke,oBo,3,2,1,285,214,71,CT,138
743,CT Peek Towards B Choke,oBo,2,3,-1,236,217,19,T,138
744,CT Banana Half Wall Side,oBo,2,1,1,197,192,5,CT,138
745,CT Banana Half Wall Side,oBo,3,5,-2,402,516,-114,T,138
746,Lane Side,oBo,3,0,3,212,0,212,CT,138
747,Lane Side,oBo,3,5,-2,366,446,-80,T,138
748,Top Mid Lane Side ,oBo,1,1,0,35,100,-65,CT,138
749,Top Mid Lane Side ,oBo,1,2,-1,21,218,-197,T,138
750,Logs,oBo,0,0,0,0,9,-9,CT,138
751,Logs,oBo,3,5,-2,508,453,55,T,138
752,A Bombsite Close Left,oBo,4,1,3,332,181,151,CT,138
753,A Bombsite Close Left,oBo,0,1,-1,0,100,-100,T,138
754,Grill,oBo,1,2,-1,283,147,136,CT,138
755,Grill,oBo,1,2,-1,100,79,21,T,138
756,Top Mid Arch Side,oBo,0,0,0,137,0,137,CT,138
757,Top Mid Arch Side,oBo,2,0,2,173,58,115,T,138
758,Middle,oBo,0,1,-1,20,100,-80,CT,138
759,Middle,oBo,0,2,-2,38,199,-161,T,138
760,Top Mid Chokepoint,oBo,0,0,0,19,0,19,CT,138
761,Top Mid Chokepoint,oBo,1,0,1,103,48,55,T,138
762,Arch Side Cubby,oBo,4,2,2,410,288,122,CT,138
763,Arch Side Cubby,oBo,0,0,0,26,0,26,T,138
764,Boiler Side Stairs,oBo,1,2,-1,27,200,-173,CT,138
765,Boiler Side Stairs,oBo,1,1,0,89,100,-11,T,138
766,B Site,oBo,0,0,0,0,0,0,CT,138
767,B Site,oBo,1,1,0,101,1,100,T,138
768,CT Outside Construction,oBo,1,0,1,81,0,81,CT,138
769,CT Outside Construction,oBo,0,0,0,0,0,0,T,138
770,Pit Peek Towards Lane,oBo,0,0,0,0,0,0,CT,138
771,Pit Peek Towards Lane,oBo,1,1,0,43,87,-44,T,138
772,CT Banana Sandbangs,oBo,0,2,-2,77,200,-123,CT,138
773,CT Banana Sandbangs,oBo,4,0,4,394,149,245,T,138
774,Front Coffins,oBo,0,0,0,0,0,0,CT,138
775,Front Coffins,oBo,0,1,-1,0,61,-61,T,138
776,SecondMid,oBo,0,0,0,0,0,0,CT,138
777,SecondMid,oBo,0,2,-2,0,183,-183,T,138
778,Bottom Mid exposed to Top Mid,oBo,2,0,2,122,0,122,CT,138
779,Bottom Mid exposed to Top Mid,oBo,2,1,1,231,100,131,T,138
780,CT Spawn ,oBo,0,0,0,0,0,0,CT,138
781,CT Spawn ,oBo,0,0,0,0,0,0,T,138
782,B Site Cross for T's Exposed to CT and Quad,oBo,0,0,0,0,0,0,CT,138
783,B Site Cross for T's Exposed to CT and Quad,oBo,0,1,-1,0,100,-100,T,138
784,Pit Below Balcony,oBo,0,0,0,0,0,0,CT,138
785,Pit Below Balcony,oBo,1,0,1,165,46,119,T,138
786,CT Boost,oBo,0,1,-1,16,75,-59,CT,138
787,CT Boost,oBo,0,0,0,0,0,0,T,138
788,CT Speed Way,oBo,0,0,0,0,0,0,CT,138
789,CT Speed Way,oBo,0,0,0,0,0,0,T,138
790,1st Oranges,oBo,0,0,0,0,0,0,CT,138
791,1st Oranges,oBo,0,0,0,0,0,0,T,138
792,A Site,oBo,2,0,2,114,0,114,CT,138
793,A Site,oBo,1,0,1,20,11,9,T,138
794,Boiler Peek to Mid,oBo,1,0,1,84,0,84,CT,138
795,Boiler Peek to Mid,oBo,0,0,0,0,0,0,T,138
796,Apps T Side Stairs,oBo,0,0,0,0,0,0,CT,138
797,Apps T Side Stairs,oBo,0,1,-1,0,78,-78,T,138
798,Apartments,oBo,1,1,0,55,100,-45,CT,138
799,Apartments,oBo,0,0,0,0,0,0,T,138
800,Behind Coffins Playing the B Site Cross,oBo,1,1,0,100,150,-50,CT,138
801,Behind Coffins Playing the B Site Cross,oBo,0,0,0,18,0,18,T,138
802,Deep Apps Past Hallway,oBo,0,0,0,0,0,0,CT,138
803,Deep Apps Past Hallway,oBo,0,1,-1,19,104,-85,T,138
804,Bottom Graveyard,oBo,0,1,-1,27,50,-23,CT,138
805,Bottom Graveyard,oBo,0,0,0,0,0,0,T,138
806,Quad Box,oBo,0,0,0,0,0,0,CT,138
807,Quad Box,oBo,0,0,0,0,0,0,T,138
808,Lane Peek Towards Top Mid,oBo,1,1,0,100,100,0,CT,138
809,Lane Peek Towards Top Mid,oBo,0,0,0,0,0,0,T,138
810,Dark,oBo,0,0,0,0,0,0,CT,138
811,Dark,oBo,0,0,0,0,0,0,T,138
812,Library,oBo,1,0,1,163,67,96,CT,138
813,Library,oBo,1,1,0,100,2,98,T,138
814,A Site Behind Middle Boxes/Pillar hidden from Lane,oBo,0,0,0,0,0,0,CT,138
815,A Site Behind Middle Boxes/Pillar hidden from Lane,oBo,0,0,0,0,0,0,T,138
816,CT Banana Sandbags Right Corner,oBo,0,0,0,0,0,0,CT,138
817,CT Banana Sandbags Right Corner,oBo,2,1,1,262,102,160,T,138
818,A Site Right Side Middle Pillar,oBo,0,1,-1,27,100,-73,CT,138
819,A Site Right Side Middle Pillar,oBo,0,0,0,0,0,0,T,138
820,Top Coffins,oBo,0,0,0,0,0,0,CT,138
821,Top Coffins,oBo,0,0,0,0,0,0,T,138
822,Bottom Mid Banana,oBo,0,0,0,0,0,0,CT,138
823,Bottom Mid Banana,oBo,0,1,-1,194,140,54,T,138
824,Deep CT Peeking Towards B Site,oBo,2,1,1,257,100,157,CT,138
825,Deep CT Peeking Towards B Site,oBo,0,0,0,0,0,0,T,138
826,CT Arch,oBo,0,0,0,0,0,0,CT,138
827,CT Arch,oBo,0,0,0,0,22,-22,T,138
828,Pit,oBo,0,0,0,0,0,0,CT,138
829,Pit,oBo,1,0,1,100,46,54,T,138
830,T Ramp Peeking Towards Mid,oBo,0,0,0,0,0,0,CT,138
831,T Ramp Peeking Towards Mid,oBo,0,1,-1,42,236,-194,T,138
832,T Apps Bridge ,oBo,0,0,0,0,0,0,CT,138
833,T Apps Bridge ,oBo,0,0,0,0,0,0,T,138
834,BDoors,oBo,0,1,-1,0,100,-100,CT,138
835,BDoors,oBo,0,0,0,0,1,-1,T,138
836,CT Banana Close Left Half Wall,oBo,0,0,0,0,0,0,CT,138
837,CT Banana Close Left Half Wall,oBo,0,0,0,0,0,0,T,138
838,Chokepoint Entrance onto A site from Library Side,oBo,1,1,0,198,100,98,CT,138
839,Chokepoint Entrance onto A site from Library Side,oBo,0,0,0,0,0,0,T,138
840,CT Outside Arch,oBo,0,0,0,0,0,0,CT,138
841,CT Outside Arch,oBo,1,0,1,100,0,100,T,138
842,Construction,oBo,0,1,-1,47,50,-3,CT,138
843,Construction,oBo,3,0,3,272,84,188,T,138
844,Apps Hallway,oBo,0,0,0,0,0,0,CT,138
845,Apps Hallway,oBo,1,0,1,100,0,100,T,138
846,Outside Library,oBo,2,1,1,176,49,127,CT,138
847,Outside Library,oBo,0,0,0,0,24,-24,T,138
848,Left Side Quadbox Peek for a CT,oBo,0,0,0,0,0,0,CT,138
849,Left Side Quadbox Peek for a CT,oBo,1,1,0,139,100,39,T,138
850,Back Alley,oBo,0,0,0,0,0,0,CT,138
851,Back Alley,oBo,0,0,0,0,0,0,T,138
852,Lane Side,Brehze,6,5,1,720,519,201,CT,138
853,Lane Side,Brehze,1,3,-2,100,282,-182,T,138
854,Top Balcony ,Brehze,1,0,1,128,84,44,CT,138
855,Top Balcony ,Brehze,2,2,0,227,230,-3,T,138
856,Top Mid Chokepoint,Brehze,1,1,0,117,127,-10,CT,138
857,Top Mid Chokepoint,Brehze,4,2,2,427,216,211,T,138
858,Chokepoint Entering B,Brehze,0,0,0,0,0,0,CT,138
859,Chokepoint Entering B,Brehze,1,3,-2,252,346,-94,T,138
860,CT Banana Half Wall Side,Brehze,0,1,-1,0,100,-100,CT,138
861,CT Banana Half Wall Side,Brehze,6,4,2,583,480,103,T,138
862,Top Mid Lane Side ,Brehze,2,3,-1,267,262,5,CT,138
863,Top Mid Lane Side ,Brehze,3,2,1,371,277,94,T,138
864,SecondMid,Brehze,1,0,1,100,0,100,CT,138
865,SecondMid,Brehze,4,0,4,341,73,268,T,138
866,Middle,Brehze,5,2,3,500,200,300,CT,138
867,Middle,Brehze,1,1,0,124,115,9,T,138
868,CT Peek Towards B Choke,Brehze,1,2,-1,166,186,-20,CT,138
869,CT Peek Towards B Choke,Brehze,2,2,0,220,212,8,T,138
870,Banana,Brehze,1,1,0,6,182,-176,CT,138
871,Banana,Brehze,1,2,-1,265,407,-142,T,138
872,Arch Side,Brehze,1,0,1,100,0,100,CT,138
873,Arch Side,Brehze,2,1,1,190,100,90,T,138
874,Behind Coffins Playing the B Site Cross,Brehze,0,2,-2,76,200,-124,CT,138
875,Behind Coffins Playing the B Site Cross,Brehze,2,1,1,126,236,-110,T,138
876,B Site Cross for T's Exposed to CT and Quad,Brehze,0,0,0,0,0,0,CT,138
877,B Site Cross for T's Exposed to CT and Quad,Brehze,1,2,-1,117,160,-43,T,138
878,Top Mid Arch Side,Brehze,1,0,1,44,22,22,CT,138
879,Top Mid Arch Side,Brehze,1,2,-1,100,248,-148,T,138
880,CT Banana Sandbangs,Brehze,0,1,-1,0,100,-100,CT,138
881,CT Banana Sandbangs,Brehze,3,1,2,315,121,194,T,138
882,Graveyard Stairs,Brehze,0,2,-2,63,114,-51,CT,138
883,Graveyard Stairs,Brehze,1,1,0,113,100,13,T,138
884,Construction,Brehze,0,0,0,0,0,0,CT,138
885,Construction,Brehze,1,1,0,111,93,18,T,138
886,Deep Apps Past Hallway,Brehze,1,0,1,194,62,132,CT,138
887,Deep Apps Past Hallway,Brehze,1,1,0,131,179,-48,T,138
888,T Apps Bridge ,Brehze,0,0,0,0,0,0,CT,138
889,T Apps Bridge ,Brehze,0,1,-1,6,100,-94,T,138
890,Boiler Room,Brehze,0,2,-2,66,200,-134,CT,138
891,Boiler Room,Brehze,0,0,0,0,0,0,T,138
892,Pit Below Balcony,Brehze,2,1,1,220,160,60,CT,138
893,Pit Below Balcony,Brehze,0,1,-1,0,97,-97,T,138
894,Arch Side Cubby,Brehze,0,0,0,0,0,0,CT,138
895,Arch Side Cubby,Brehze,0,0,0,0,0,0,T,138
896,Top Coffins,Brehze,0,1,-1,34,40,-6,CT,138
897,Top Coffins,Brehze,0,1,-1,0,90,-90,T,138
898,Deep CT Peeking Towards B Site,Brehze,0,0,0,0,0,0,CT,138
899,Deep CT Peeking Towards B Site,Brehze,2,1,1,138,86,52,T,138
900,B Site,Brehze,0,0,0,0,0,0,CT,138
901,B Site,Brehze,2,3,-1,169,277,-108,T,138
902,2nd Oranges,Brehze,0,0,0,0,0,0,CT,138
903,2nd Oranges,Brehze,0,1,-1,0,76,-76,T,138
904,A Bombsite Close Left,Brehze,3,1,2,206,100,106,CT,138
905,A Bombsite Close Left,Brehze,0,0,0,0,0,0,T,138
906,CT Spawn ,Brehze,0,0,0,0,0,0,CT,138
907,CT Spawn ,Brehze,0,1,-1,0,89,-89,T,138
908,Apps Hallway,Brehze,1,0,1,194,13,181,CT,138
909,Apps Hallway,Brehze,0,0,0,16,2,14,T,138
910,T Ramp Peeking Towards Mid,Brehze,0,1,-1,0,100,-100,CT,138
911,T Ramp Peeking Towards Mid,Brehze,0,1,-1,0,100,-100,T,138
912,A Site,Brehze,0,0,0,0,0,0,CT,138
913,A Site,Brehze,1,0,1,35,0,35,T,138
914,A Site Behind Default Boxes,Brehze,2,2,0,266,251,15,CT,138
915,A Site Behind Default Boxes,Brehze,0,0,0,0,0,0,T,138
916,Lane Patio,Brehze,1,0,1,100,0,100,CT,138
917,Lane Patio,Brehze,0,0,0,0,0,0,T,138
918,Underpass,Brehze,0,0,0,0,0,0,CT,138
919,Underpass,Brehze,0,1,-1,0,83,-83,T,138
920,Outside Library,Brehze,0,0,0,0,0,0,CT,138
921,Outside Library,Brehze,0,1,-1,0,46,-46,T,138
922,A Site Behind Middle Boxes/Pillar hidden from Lane,Brehze,1,1,0,28,127,-99,CT,138
923,A Site Behind Middle Boxes/Pillar hidden from Lane,Brehze,0,0,0,0,0,0,T,138
924,Apps T Side Stairs,Brehze,0,0,0,0,0,0,CT,138
925,Apps T Side Stairs,Brehze,0,2,-2,0,200,-200,T,138
926,CT Banana Barrels,Brehze,0,0,0,0,0,0,CT,138
927,CT Banana Barrels,Brehze,0,0,0,0,0,0,T,138
928,1st Oranges,Brehze,0,0,0,0,0,0,CT,138
929,1st Oranges,Brehze,0,0,0,6,22,-16,T,138
930,LowerMid,Brehze,0,0,0,0,0,0,CT,138
931,LowerMid,Brehze,1,0,1,138,0,138,T,138
932,Grill,Brehze,0,0,0,0,0,0,CT,138
933,Grill,Brehze,1,1,0,100,110,-10,T,138
934,Top Hay Bales,Brehze,0,0,0,0,0,0,CT,138
935,Top Hay Bales,Brehze,0,0,0,0,0,0,T,138
936,CT Outside Kitchen,Brehze,0,0,0,0,0,0,CT,138
937,CT Outside Kitchen,Brehze,1,1,0,100,56,44,T,138
938,Lane Peek Towards Top Mid,Brehze,0,0,0,0,0,0,CT,138
939,Lane Peek Towards Top Mid,Brehze,0,0,0,0,0,0,T,138
940,Quad Box,Brehze,0,0,0,0,0,0,CT,138
941,Quad Box,Brehze,0,0,0,0,0,0,T,138
942,A Site Right Side Middle Pillar,Brehze,0,0,0,22,0,22,CT,138
943,A Site Right Side Middle Pillar,Brehze,0,0,0,3,0,3,T,138
944,Library,Brehze,0,0,0,0,0,0,CT,138
945,Library,Brehze,0,0,0,0,0,0,T,138
946,Front Coffins,Brehze,0,0,0,0,0,0,CT,138
947,Front Coffins,Brehze,0,1,-1,0,79,-79,T,138
948,Pit,Brehze,1,1,0,84,221,-137,CT,138
949,Pit,Brehze,0,0,0,0,0,0,T,138
950,Pit Peek Towards Lane,Brehze,5,0,5,451,76,375,CT,138
951,Pit Peek Towards Lane,Brehze,0,0,0,0,0,0,T,138
952,CT Arch,Brehze,0,0,0,0,0,0,CT,138
953,CT Arch,Brehze,0,1,-1,0,100,-100,T,138
954,Boiler Side Stairs,Brehze,0,0,0,41,8,33,CT,138
955,Boiler Side Stairs,Brehze,1,0,1,100,28,72,T,138
956,CT Boost,Brehze,0,1,-1,0,100,-100,CT,138
957,CT Boost,Brehze,0,0,0,0,0,0,T,138
958,CT Speed Way,Brehze,0,0,0,0,0,0,CT,138
959,CT Speed Way,Brehze,0,0,0,0,0,0,T,138
960,Boiler Peek to Mid,Brehze,0,0,0,16,0,16,CT,138
961,Boiler Peek to Mid,Brehze,3,0,3,270,48,222,T,138
962,Chokepoint Entrance onto A site from Library Side,Brehze,0,0,0,0,0,0,CT,138
963,Chokepoint Entrance onto A site from Library Side,Brehze,0,0,0,0,0,0,T,138
964,Bottom Graveyard,Brehze,0,1,-1,34,63,-29,CT,138
965,Bottom Graveyard,Brehze,0,0,0,0,0,0,T,138
966,Upstairs,Brehze,0,0,0,0,0,0,CT,138
967,Upstairs,Brehze,0,1,-1,0,100,-100,T,138
968,CT Outside Construction,Brehze,0,0,0,0,0,0,CT,138
969,CT Outside Construction,Brehze,0,0,0,0,0,0,T,138
970,Bottom Mid exposed to Top Mid,Brehze,0,0,0,0,0,0,CT,138
971,Bottom Mid exposed to Top Mid,Brehze,2,0,2,200,0,200,T,138
972,Arch Side CT Corner Peeking Towards Top Mid,Brehze,1,1,0,154,100,54,CT,138
973,Arch Side CT Corner Peeking Towards Top Mid,Brehze,1,0,1,100,38,62,T,138
974,Banana,flameZ,0,2,-2,27,188,-161,CT,133
975,Banana,flameZ,3,9,-6,570,1248,-678,T,133
976,Chokepoint Entering B,flameZ,0,4,-4,600,607,-7,CT,133
977,Chokepoint Entering B,flameZ,5,9,-4,348,1017,-669,T,133
978,CT Banana Half Wall Side,flameZ,3,3,0,286,308,-22,CT,133
979,CT Banana Half Wall Side,flameZ,3,1,2,244,108,136,T,133
980,CT Peek Towards B Choke,flameZ,1,1,0,117,129,-12,CT,133
981,CT Peek Towards B Choke,flameZ,1,0,1,185,28,157,T,133
982,1st Oranges,flameZ,5,2,3,338,176,162,CT,133
983,1st Oranges,flameZ,0,1,-1,123,87,36,T,133
984,Top Mid Arch Side,flameZ,1,1,0,52,100,-48,CT,133
985,Top Mid Arch Side,flameZ,1,3,-2,135,268,-133,T,133
986,Arch Side,flameZ,1,2,-1,21,198,-177,CT,133
987,Arch Side,flameZ,2,0,2,200,34,166,T,133
988,Top Coffins,flameZ,0,2,-2,136,200,-64,CT,133
989,Top Coffins,flameZ,0,0,0,0,0,0,T,133
990,Behind Coffins Playing the B Site Cross,flameZ,0,3,-3,0,179,-179,CT,133
991,Behind Coffins Playing the B Site Cross,flameZ,1,0,1,100,52,48,T,133
992,CT Banana Sandbangs,flameZ,10,1,9,746,151,595,CT,133
993,CT Banana Sandbangs,flameZ,1,0,1,39,0,39,T,133
994,Grill,flameZ,1,0,1,59,0,59,CT,133
995,Grill,flameZ,4,0,4,221,152,69,T,133
996,A Site Behind Middle Boxes/Pillar hidden from Lane,flameZ,0,1,-1,0,8,-8,CT,133
997,A Site Behind Middle Boxes/Pillar hidden from Lane,flameZ,0,1,-1,0,22,-22,T,133
998,Pit Peek Towards Lane,flameZ,0,0,0,0,0,0,CT,133
999,Pit Peek Towards Lane,flameZ,1,0,1,60,22,38,T,133
1000,Library,flameZ,1,0,1,49,5,44,CT,133
1001,Library,flameZ,1,1,0,100,100,0,T,133
1002,Apps T Side Stairs,flameZ,0,0,0,0,0,0,CT,133
1003,Apps T Side Stairs,flameZ,1,2,-1,119,159,-40,T,133
1004,CT Banana Barrels,flameZ,3,0,3,223,136,87,CT,133
1005,CT Banana Barrels,flameZ,0,1,-1,81,200,-119,T,133
1006,Logs,flameZ,0,1,-1,91,73,18,CT,133
1007,Logs,flameZ,0,1,-1,49,44,5,T,133
1008,Top Mid Lane Side ,flameZ,2,1,1,139,100,39,CT,133
1009,Top Mid Lane Side ,flameZ,0,1,-1,27,100,-73,T,133
1010,A Site Behind Default Boxes,flameZ,0,0,0,0,0,0,CT,133
1011,A Site Behind Default Boxes,flameZ,0,0,0,0,0,0,T,133
1012,2nd Oranges,flameZ,3,1,2,171,100,71,CT,133
1013,2nd Oranges,flameZ,0,0,0,0,0,0,T,133
1014,B Site,flameZ,0,0,0,46,94,-48,CT,133
1015,B Site,flameZ,1,1,0,54,65,-11,T,133
1016,Top Mid Chokepoint,flameZ,0,0,0,0,0,0,CT,133
1017,Top Mid Chokepoint,flameZ,0,1,-1,0,100,-100,T,133
1018,A Site,flameZ,4,0,4,200,24,176,CT,133
1019,A Site,flameZ,2,1,1,253,100,153,T,133
1020,Bottom Mid Banana,flameZ,0,0,0,0,0,0,CT,133
1021,Bottom Mid Banana,flameZ,0,2,-2,26,252,-226,T,133
1022,Arch Side Cubby,flameZ,1,2,-1,144,200,-56,CT,133
1023,Arch Side Cubby,flameZ,0,0,0,0,0,0,T,133
1024,Lane Behind Pillar,flameZ,0,1,-1,0,81,-81,CT,133
1025,Lane Behind Pillar,flameZ,0,0,0,0,0,0,T,133
1026,Fountain,flameZ,0,0,0,0,0,0,CT,133
1027,Fountain,flameZ,1,0,1,73,3,70,T,133
1028,T Ramp Peeking Towards Mid,flameZ,0,0,0,0,0,0,CT,133
1029,T Ramp Peeking Towards Mid,flameZ,0,1,-1,206,217,-11,T,133
1030,B Site Cross for T's Exposed to CT and Quad,flameZ,4,0,4,268,81,187,CT,133
1031,B Site Cross for T's Exposed to CT and Quad,flameZ,1,1,0,156,36,120,T,133
1032,CT Arch,flameZ,0,0,0,0,0,0,CT,133
1033,CT Arch,flameZ,1,0,1,84,0,84,T,133
1034,Deep CT Peeking Towards B Site,flameZ,1,1,0,33,95,-62,CT,133
1035,Deep CT Peeking Towards B Site,flameZ,0,0,0,0,0,0,T,133
1036,Boiler Side Stairs,flameZ,0,1,-1,0,100,-100,CT,133
1037,Boiler Side Stairs,flameZ,0,0,0,0,0,0,T,133
1038,Pit Below Balcony,flameZ,0,0,0,0,0,0,CT,133
1039,Pit Below Balcony,flameZ,1,1,0,74,148,-74,T,133
1040,Middle,flameZ,0,0,0,0,0,0,CT,133
1041,Middle,flameZ,0,1,-1,43,37,6,T,133
1042,Lane Side,flameZ,0,1,-1,0,74,-74,CT,133
1043,Lane Side,flameZ,0,0,0,18,0,18,T,133
1044,Dark,flameZ,2,1,1,24,100,-76,CT,133
1045,Dark,flameZ,0,1,-1,27,84,-57,T,133
1046,Lane Peek Towards Top Mid,flameZ,0,2,-2,0,200,-200,CT,133
1047,Lane Peek Towards Top Mid,flameZ,0,0,0,0,0,0,T,133
1048,A Bombsite Back Site,flameZ,0,1,-1,150,100,50,CT,133
1049,A Bombsite Back Site,flameZ,0,0,0,0,0,0,T,133
1050,CT Outside Construction,flameZ,0,1,-1,1,100,-99,CT,133
1051,CT Outside Construction,flameZ,0,0,0,0,0,0,T,133
1052,Pit,flameZ,0,0,0,0,0,0,CT,133
1053,Pit,flameZ,0,0,0,0,0,0,T,133
1054,CT Tree,flameZ,1,1,0,89,100,-11,CT,133
1055,CT Tree,flameZ,1,0,1,63,71,-8,T,133
1056,Default Plant A Site,flameZ,0,0,0,0,0,0,CT,133
1057,Default Plant A Site,flameZ,0,0,0,0,0,0,T,133
1058,T Apps Bridge ,flameZ,0,1,-1,36,70,-34,CT,133
1059,T Apps Bridge ,flameZ,0,0,0,0,0,0,T,133
1060,SecondMid,flameZ,1,0,1,8,27,-19,CT,133
1061,SecondMid,flameZ,1,0,1,100,0,100,T,133
1062,Front Coffins,flameZ,0,0,0,0,0,0,CT,133
1063,Front Coffins,flameZ,1,1,0,100,113,-13,T,133
1064,Construction Sandbags,flameZ,0,0,0,0,0,0,CT,133
1065,Construction Sandbags,flameZ,0,1,-1,55,100,-45,T,133
1066,Underpass,flameZ,0,0,0,0,0,0,CT,133
1067,Underpass,flameZ,3,1,2,271,156,115,T,133
1068,Left Side Quadbox Peek for a CT,flameZ,0,1,-1,33,100,-67,CT,133
1069,Left Side Quadbox Peek for a CT,flameZ,0,0,0,0,0,0,T,133
1070,Top Balcony ,flameZ,0,0,0,0,0,0,CT,133
1071,Top Balcony ,flameZ,1,1,0,97,4,93,T,133
1072,Quad Box,flameZ,0,0,0,25,0,25,CT,133
1073,Quad Box,flameZ,0,0,0,85,26,59,T,133
1074,T Ramp Ledge,flameZ,0,0,0,0,0,0,CT,133
1075,T Ramp Ledge,flameZ,0,1,-1,60,100,-40,T,133
1076,CT Banana Sandbags Right Corner,flameZ,0,0,0,0,0,0,CT,133
1077,CT Banana Sandbags Right Corner,flameZ,0,1,-1,0,9,-9,T,133
1078,CT Outside Kitchen,flameZ,0,0,0,0,0,0,CT,133
1079,CT Outside Kitchen,flameZ,0,0,0,0,0,0,T,133
1080,A Bombsite Close Left,flameZ,0,0,0,0,0,0,CT,133
1081,A Bombsite Close Left,flameZ,0,0,0,0,0,0,T,133
1082,Boiler Room,flameZ,0,1,-1,0,100,-100,CT,133
1083,Boiler Room,flameZ,0,0,0,0,0,0,T,133
1084,Behind B Site Back Pillar,flameZ,0,0,0,0,0,0,CT,133
1085,Behind B Site Back Pillar,flameZ,0,0,0,0,0,0,T,133
1086,CT Speed Way,flameZ,0,1,-1,0,100,-100,CT,133
1087,CT Speed Way,flameZ,0,0,0,0,0,0,T,133
1088,Bottom Graveyard,flameZ,0,0,0,0,0,0,CT,133
1089,Bottom Graveyard,flameZ,0,0,0,0,0,0,T,133
1090,Chokepoint Entrance onto A site from Library Side,flameZ,1,0,1,100,0,100,CT,133
1091,Chokepoint Entrance onto A site from Library Side,flameZ,1,0,1,100,0,100,T,133
1092,Graveyard Stairs,flameZ,0,0,0,0,0,0,CT,133
1093,Graveyard Stairs,flameZ,1,1,0,127,28,99,T,133
1094,CT Outside Arch,flameZ,1,1,0,100,100,0,CT,133
1095,CT Outside Arch,flameZ,0,0,0,0,0,0,T,133
1096,Top Hay Bales,flameZ,0,0,0,0,0,0,CT,133
1097,Top Hay Bales,flameZ,1,0,1,56,85,-29,T,133
1098,Construction,flameZ,1,0,1,86,0,86,CT,133
1099,Construction,flameZ,0,0,0,0,0,0,T,133
1100,Deep Apps Past Hallway,flameZ,0,0,0,0,0,0,CT,133
1101,Deep Apps Past Hallway,flameZ,1,1,0,47,100,-53,T,133
1102,Outside Library,flameZ,0,1,-1,0,100,-100,CT,133
1103,Outside Library,flameZ,1,0,1,100,0,100,T,133
1104,TSpawn,flameZ,0,0,0,0,0,0,CT,133
1105,TSpawn,flameZ,1,0,1,11,0,11,T,133
1106,Lane Side,Jame,2,3,-1,177,357,-180,CT,141
1107,Lane Side,Jame,4,4,0,403,454,-51,T,141
1108,Top Mid Lane Side ,Jame,9,4,5,909,510,399,CT,141
1109,Top Mid Lane Side ,Jame,1,2,-1,138,231,-93,T,141
1110,Chokepoint Entering B,Jame,0,0,0,119,0,119,CT,141
1111,Chokepoint Entering B,Jame,4,4,0,481,521,-40,T,141
1112,Middle,Jame,0,1,-1,0,100,-100,CT,141
1113,Middle,Jame,0,4,-4,55,355,-300,T,141
1114,Arch Side,Jame,1,3,-2,163,249,-86,CT,141
1115,Arch Side,Jame,0,0,0,10,0,10,T,141
1116,B Site,Jame,1,0,1,160,74,86,CT,141
1117,B Site,Jame,2,3,-1,254,228,26,T,141
1118,Top Mid Arch Side,Jame,0,0,0,0,27,-27,CT,141
1119,Top Mid Arch Side,Jame,0,0,0,36,0,36,T,141
1120,CT Peek Towards B Choke,Jame,8,0,8,437,117,320,CT,141
1121,CT Peek Towards B Choke,Jame,0,1,-1,0,108,-108,T,141
1122,T Ramp Peeking Towards Mid,Jame,1,1,0,171,100,71,CT,141
1123,T Ramp Peeking Towards Mid,Jame,1,3,-2,180,429,-249,T,141
1124,Banana,Jame,0,0,0,0,0,0,CT,141
1125,Banana,Jame,1,0,1,278,116,162,T,141
1126,Top Mid Chokepoint,Jame,0,0,0,0,0,0,CT,141
1127,Top Mid Chokepoint,Jame,2,2,0,247,350,-103,T,141
1128,A Site,Jame,1,0,1,100,0,100,CT,141
1129,A Site,Jame,1,1,0,67,100,-33,T,141
1130,Top Balcony ,Jame,2,1,1,357,113,244,CT,141
1131,Top Balcony ,Jame,0,1,-1,0,54,-54,T,141
1132,CT Banana Half Wall Side,Jame,2,0,2,117,40,77,CT,141
1133,CT Banana Half Wall Side,Jame,2,2,0,282,123,159,T,141
1134,Chokepoint Entrance onto A site from Library Side,Jame,3,1,2,287,125,162,CT,141
1135,Chokepoint Entrance onto A site from Library Side,Jame,0,0,0,0,0,0,T,141
1136,Deep CT Peeking Towards B Site,Jame,0,2,-2,53,131,-78,CT,141
1137,Deep CT Peeking Towards B Site,Jame,0,0,0,0,0,0,T,141
1138,Library,Jame,6,2,4,391,200,191,CT,141
1139,Library,Jame,0,0,0,0,0,0,T,141
1140,Bottom Mid exposed to Top Mid,Jame,0,0,0,0,0,0,CT,141
1141,Bottom Mid exposed to Top Mid,Jame,1,1,0,100,162,-62,T,141
1142,Behind Coffins Playing the B Site Cross,Jame,4,1,3,391,155,236,CT,141
1143,Behind Coffins Playing the B Site Cross,Jame,0,0,0,0,0,0,T,141
1144,B Site Cross for T's Exposed to CT and Quad,Jame,0,0,0,0,0,0,CT,141
1145,B Site Cross for T's Exposed to CT and Quad,Jame,0,1,-1,0,130,-130,T,141
1146,Grill,Jame,0,0,0,0,0,0,CT,141
1147,Grill,Jame,0,1,-1,0,50,-50,T,141
1148,2nd Oranges,Jame,0,0,0,0,0,0,CT,141
1149,2nd Oranges,Jame,1,1,0,46,100,-54,T,141
1150,Pit,Jame,0,0,0,0,0,0,CT,141
1151,Pit,Jame,0,0,0,0,0,0,T,141
1152,Left Side Quadbox Peek for a CT,Jame,0,0,0,0,0,0,CT,141
1153,Left Side Quadbox Peek for a CT,Jame,0,0,0,0,0,0,T,141
1154,SecondMid,Jame,0,0,0,0,2,-2,CT,141
1155,SecondMid,Jame,0,2,-2,40,202,-162,T,141
1156,A Site Right Side Middle Pillar,Jame,4,1,3,307,208,99,CT,141
1157,A Site Right Side Middle Pillar,Jame,1,0,1,100,4,96,T,141
1158,Default Plant A Site,Jame,0,0,0,0,6,-6,CT,141
1159,Default Plant A Site,Jame,1,1,0,12,81,-69,T,141
1160,CT Banana Barrels,Jame,2,0,2,196,53,143,CT,141
1161,CT Banana Barrels,Jame,0,1,-1,0,86,-86,T,141
1162,Back Alley,Jame,1,1,0,100,104,-4,CT,141
1163,Back Alley,Jame,0,0,0,0,0,0,T,141
1164,A Bombsite Back Site,Jame,1,1,0,85,19,66,CT,141
1165,A Bombsite Back Site,Jame,2,1,1,193,122,71,T,141
1166,CT Banana Sandbangs,Jame,0,0,0,0,0,0,CT,141
1167,CT Banana Sandbangs,Jame,0,2,-2,0,128,-128,T,141
1168,A Bombsite Close Left,Jame,0,0,0,0,0,0,CT,141
1169,A Bombsite Close Left,Jame,3,0,3,255,8,247,T,141
1170,CT Banana Sandbags Right Corner,Jame,0,0,0,0,0,0,CT,141
1171,CT Banana Sandbags Right Corner,Jame,1,0,1,46,58,-12,T,141
1172,Underpass,Jame,0,0,0,0,4,-4,CT,141
1173,Underpass,Jame,1,0,1,46,23,23,T,141
1174,Lane Peek Towards Top Mid,Jame,0,0,0,0,9,-9,CT,141
1175,Lane Peek Towards Top Mid,Jame,0,0,0,0,0,0,T,141
1176,Dark,Jame,0,0,0,0,0,0,CT,141
1177,Dark,Jame,0,0,0,0,0,0,T,141
1178,1st Oranges,Jame,1,1,0,90,100,-10,CT,141
1179,1st Oranges,Jame,1,0,1,100,0,100,T,141
1180,Pit Peek Towards Lane,Jame,0,0,0,0,0,0,CT,141
1181,Pit Peek Towards Lane,Jame,1,0,1,154,0,154,T,141
1182,CT Outside Construction,Jame,2,0,2,181,0,181,CT,141
1183,CT Outside Construction,Jame,0,0,0,0,0,0,T,141
1184,Apps T Side Stairs,Jame,0,0,0,0,0,0,CT,141
1185,Apps T Side Stairs,Jame,0,0,0,0,0,0,T,141
1186,T Ramp Ledge,Jame,0,0,0,0,0,0,CT,141
1187,T Ramp Ledge,Jame,0,1,-1,82,100,-18,T,141
1188,A Site Behind Middle Boxes/Pillar hidden from Lane,Jame,1,0,1,89,0,89,CT,141
1189,A Site Behind Middle Boxes/Pillar hidden from Lane,Jame,0,0,0,0,0,0,T,141
1190,Arch Side Cubby,Jame,1,1,0,167,100,67,CT,141
1191,Arch Side Cubby,Jame,0,0,0,0,0,0,T,141
1192,Boiler Peek to Mid,Jame,0,1,-1,21,100,-79,CT,141
1193,Boiler Peek to Mid,Jame,1,0,1,100,0,100,T,141
1194,Right Side Quadbox Peek for a CT,Jame,0,0,0,0,0,0,CT,141
1195,Right Side Quadbox Peek for a CT,Jame,1,1,0,100,42,58,T,141
1196,Boiler Side Stairs,Jame,1,0,1,100,64,36,CT,141
1197,Boiler Side Stairs,Jame,0,0,0,0,43,-43,T,141
1198,T Apps Bridge ,Jame,0,1,-1,0,100,-100,CT,141
1199,T Apps Bridge ,Jame,0,0,0,0,0,0,T,141
1200,Apartments,Jame,0,0,0,0,0,0,CT,141
1201,Apartments,Jame,0,0,0,0,0,0,T,141
1202,Apartments Hallway Peek from T Side,Jame,0,0,0,0,0,0,CT,141
1203,Apartments Hallway Peek from T Side,Jame,0,0,0,0,0,0,T,141
1204,Front Coffins,Jame,0,0,0,0,0,0,CT,141
1205,Front Coffins,Jame,0,1,-1,0,100,-100,T,141
1206,CT Banana Close Left Half Wall,Jame,2,0,2,200,0,200,CT,141
1207,CT Banana Close Left Half Wall,Jame,0,0,0,0,0,0,T,141
1208,A Site Behind Default Boxes,Jame,0,0,0,0,0,0,CT,141
1209,A Site Behind Default Boxes,Jame,0,0,0,0,0,0,T,141
1210,CT Outside Arch,Jame,0,0,0,1,0,1,CT,141
1211,CT Outside Arch,Jame,0,0,0,0,0,0,T,141
1212,Construction,Jame,1,0,1,109,54,55,CT,141
1213,Construction,Jame,0,0,0,0,0,0,T,141
1214,Chokepoint Entering B,buster,2,4,-2,556,514,42,CT,141
1215,Chokepoint Entering B,buster,8,5,3,820,510,310,T,141
1216,Banana,buster,0,0,0,0,13,-13,CT,141
1217,Banana,buster,6,4,2,600,755,-155,T,141
1218,CT Banana Half Wall Side,buster,10,3,7,968,209,759,CT,141
1219,CT Banana Half Wall Side,buster,2,2,0,211,258,-47,T,141
1220,B Site Cross for T's Exposed to CT and Quad,buster,0,1,-1,2,73,-71,CT,141
1221,B Site Cross for T's Exposed to CT and Quad,buster,0,0,0,67,75,-8,T,141
1222,Top Mid Lane Side ,buster,0,4,-4,162,399,-237,CT,141
1223,Top Mid Lane Side ,buster,2,1,1,281,244,37,T,141
1224,Lane Side,buster,0,3,-3,56,300,-244,CT,141
1225,Lane Side,buster,4,4,0,212,351,-139,T,141
1226,T Ramp Peeking Towards Mid,buster,0,0,0,0,0,0,CT,141
1227,T Ramp Peeking Towards Mid,buster,0,1,-1,31,100,-69,T,141
1228,CT Peek Towards B Choke,buster,0,1,-1,0,138,-138,CT,141
1229,CT Peek Towards B Choke,buster,0,1,-1,0,48,-48,T,141
1230,Grill,buster,0,0,0,0,0,0,CT,141
1231,Grill,buster,4,3,1,405,311,94,T,141
1232,Top Balcony ,buster,0,0,0,0,0,0,CT,141
1233,Top Balcony ,buster,3,3,0,374,490,-116,T,141
1234,2nd Oranges,buster,2,0,2,95,0,95,CT,141
1235,2nd Oranges,buster,0,0,0,0,0,0,T,141
1236,Logs,buster,1,1,0,100,100,0,CT,141
1237,Logs,buster,2,0,2,239,108,131,T,141
1238,B Site,buster,0,1,-1,10,100,-90,CT,141
1239,B Site,buster,2,0,2,234,15,219,T,141
1240,Behind Coffins Playing the B Site Cross,buster,2,3,-1,163,285,-122,CT,141
1241,Behind Coffins Playing the B Site Cross,buster,1,0,1,24,0,24,T,141
1242,Arch Side,buster,2,1,1,293,175,118,CT,141
1243,Arch Side,buster,0,1,-1,27,85,-58,T,141
1244,Top Mid Arch Side,buster,0,0,0,32,32,0,CT,141
1245,Top Mid Arch Side,buster,1,3,-2,171,248,-77,T,141
1246,Bottom Mid Banana,buster,1,0,1,100,60,40,CT,141
1247,Bottom Mid Banana,buster,1,2,-1,32,235,-203,T,141
1248,Quad Box,buster,3,3,0,327,244,83,CT,141
1249,Quad Box,buster,1,0,1,100,0,100,T,141
1250,Dark,buster,0,0,0,0,0,0,CT,141
1251,Dark,buster,1,1,0,74,3,71,T,141
1252,A Bombsite Close Left,buster,0,0,0,0,0,0,CT,141
1253,A Bombsite Close Left,buster,0,1,-1,0,100,-100,T,141
1254,Middle,buster,0,1,-1,0,7,-7,CT,141
1255,Middle,buster,0,0,0,15,0,15,T,141
1256,1st Oranges,buster,1,0,1,176,13,163,CT,141
1257,1st Oranges,buster,0,0,0,0,0,0,T,141
1258,A Site Behind Middle Boxes/Pillar hidden from Lane,buster,0,0,0,0,0,0,CT,141
1259,A Site Behind Middle Boxes/Pillar hidden from Lane,buster,0,0,0,0,0,0,T,141
1260,Lane Behind Pillar,buster,0,0,0,0,0,0,CT,141
1261,Lane Behind Pillar,buster,0,0,0,13,0,13,T,141
1262,Outside Library,buster,0,2,-2,35,168,-133,CT,141
1263,Outside Library,buster,0,0,0,0,0,0,T,141
1264,Left Side Quadbox Peek for a CT,buster,2,0,2,88,101,-13,CT,141
1265,Left Side Quadbox Peek for a CT,buster,0,0,0,0,0,0,T,141
1266,Pit,buster,0,0,0,0,0,0,CT,141
1267,Pit,buster,2,0,2,174,30,144,T,141
1268,CT Tree,buster,0,0,0,0,0,0,CT,141
1269,CT Tree,buster,0,0,0,0,0,0,T,141
1270,Bottom Mid exposed to Top Mid,buster,0,0,0,0,93,-93,CT,141
1271,Bottom Mid exposed to Top Mid,buster,0,0,0,0,0,0,T,141
1272,Pit Peek Towards Lane,buster,0,0,0,0,0,0,CT,141
1273,Pit Peek Towards Lane,buster,0,0,0,26,0,26,T,141
1274,A Site,buster,1,0,1,30,0,30,CT,141
1275,A Site,buster,1,0,1,100,0,100,T,141
1276,CT Banana Sandbangs,buster,0,0,0,19,6,13,CT,141
1277,CT Banana Sandbangs,buster,2,1,1,197,100,97,T,141
1278,Apps T Side Stairs,buster,1,0,1,104,57,47,CT,141
1279,Apps T Side Stairs,buster,1,2,-1,100,73,27,T,141
1280,Right Side Quadbox Peek for a CT,buster,2,1,1,128,99,29,CT,141
1281,Right Side Quadbox Peek for a CT,buster,0,0,0,0,0,0,T,141
1282,Top Coffins,buster,0,1,-1,156,102,54,CT,141
1283,Top Coffins,buster,1,1,0,141,96,45,T,141
1284,Behind B Site Back Pillar,buster,0,0,0,0,0,0,CT,141
1285,Behind B Site Back Pillar,buster,2,1,1,194,135,59,T,141
1286,A Site Right Side Middle Pillar,buster,0,0,0,0,0,0,CT,141
1287,A Site Right Side Middle Pillar,buster,2,0,2,115,0,115,T,141
1288,Apartments,buster,0,0,0,0,0,0,CT,141
1289,Apartments,buster,0,0,0,0,0,0,T,141
1290,Underpass,buster,1,0,1,100,0,100,CT,141
1291,Underpass,buster,0,0,0,2,71,-69,T,141
1292,Attic,buster,0,0,0,0,0,0,CT,141
1293,Attic,buster,0,1,-1,0,70,-70,T,141
1294,Lane Patio,buster,0,0,0,0,0,0,CT,141
1295,Lane Patio,buster,0,0,0,0,8,-8,T,141
1296,T Ramp Ledge,buster,0,0,0,0,0,0,CT,141
1297,T Ramp Ledge,buster,0,0,0,0,0,0,T,141
1298,CT Banana Sandbags Right Corner,buster,0,1,-1,0,101,-101,CT,141
1299,CT Banana Sandbags Right Corner,buster,0,0,0,0,19,-19,T,141
1300,Library,buster,1,0,1,100,0,100,CT,141
1301,Library,buster,0,0,0,0,0,0,T,141
1302,CT Spawn ,buster,0,0,0,0,0,0,CT,141
1303,CT Spawn ,buster,0,0,0,0,0,0,T,141
1304,Construction,buster,1,1,0,96,193,-97,CT,141
1305,Construction,buster,0,0,0,0,0,0,T,141
1306,Control,buster,0,0,0,0,0,0,CT,141
1307,Control,buster,0,1,-1,0,142,-142,T,141
1308,CT Near Well,buster,0,0,0,0,0,0,CT,141
1309,CT Near Well,buster,0,0,0,0,1,-1,T,141
1310,Boiler Side Stairs,buster,0,0,0,19,27,-8,CT,141
1311,Boiler Side Stairs,buster,0,1,-1,0,78,-78,T,141
1312,Fountain,buster,1,0,1,5,0,5,CT,141
1313,Fountain,buster,0,0,0,0,0,0,T,141
1314,Chokepoint Entrance onto A site from Library Side,buster,0,1,-1,77,56,21,CT,141
1315,Chokepoint Entrance onto A site from Library Side,buster,0,0,0,0,0,0,T,141
1316,Top Graveyard,buster,0,0,0,0,0,0,CT,141
1317,Top Graveyard,buster,0,0,0,0,0,0,T,141
1318,T Apps,buster,0,1,-1,0,100,-100,CT,141
1319,T Apps,buster,0,0,0,0,0,0,T,141
1320,Front Coffins,buster,0,0,0,0,0,0,CT,141
1321,Front Coffins,buster,0,0,0,0,57,-57,T,141
1322,SecondMid,buster,0,0,0,0,0,0,CT,141
1323,SecondMid,buster,0,1,-1,22,103,-81,T,141
1324,CT Banana Close Left Half Wall,buster,3,1,2,300,132,168,CT,141
1325,CT Banana Close Left Half Wall,buster,0,0,0,0,13,-13,T,141
1326,Back Alley,buster,0,0,0,0,0,0,CT,141
1327,Back Alley,buster,0,1,-1,0,22,-22,T,141
1328,Arch Side,REZ,5,3,2,580,349,231,CT,153
1329,Arch Side,REZ,1,6,-5,92,496,-404,T,153
1330,A Bombsite Close Left,REZ,0,1,-1,143,100,43,CT,153
1331,A Bombsite Close Left,REZ,3,4,-1,311,351,-40,T,153
1332,Lane Side,REZ,2,3,-1,288,383,-95,CT,153
1333,Lane Side,REZ,1,5,-4,138,457,-319,T,153
1334,Top Mid Chokepoint,REZ,2,1,1,271,113,158,CT,153
1335,Top Mid Chokepoint,REZ,4,3,1,475,280,195,T,153
1336,Top Mid Arch Side,REZ,0,1,-1,65,70,-5,CT,153
1337,Top Mid Arch Side,REZ,5,1,4,517,163,354,T,153
1338,SecondMid,REZ,1,2,-1,25,200,-175,CT,153
1339,SecondMid,REZ,3,3,0,302,271,31,T,153
1340,Boiler Side Stairs,REZ,0,3,-3,22,296,-274,CT,153
1341,Boiler Side Stairs,REZ,0,0,0,0,0,0,T,153
1342,Pit Below Balcony,REZ,0,0,0,24,0,24,CT,153
1343,Pit Below Balcony,REZ,1,0,1,73,0,73,T,153
1344,A Site Behind Middle Boxes/Pillar hidden from Lane,REZ,1,2,-1,165,24,141,CT,153
1345,A Site Behind Middle Boxes/Pillar hidden from Lane,REZ,0,1,-1,0,21,-21,T,153
1346,Top Mid Lane Side ,REZ,1,0,1,252,63,189,CT,153
1347,Top Mid Lane Side ,REZ,7,2,5,659,553,106,T,153
1348,Banana,REZ,1,1,0,100,100,0,CT,153
1349,Banana,REZ,3,1,2,413,223,190,T,153
1350,CT Banana Half Wall Side,REZ,0,0,0,0,0,0,CT,153
1351,CT Banana Half Wall Side,REZ,0,0,0,17,87,-70,T,153
1352,Lane Patio,REZ,1,0,1,100,49,51,CT,153
1353,Lane Patio,REZ,0,2,-2,60,27,33,T,153
1354,Behind Coffins Playing the B Site Cross,REZ,0,1,-1,50,100,-50,CT,153
1355,Behind Coffins Playing the B Site Cross,REZ,0,1,-1,10,99,-89,T,153
1356,Boiler Room,REZ,0,1,-1,45,100,-55,CT,153
1357,Boiler Room,REZ,0,1,-1,25,119,-94,T,153
1358,Middle,REZ,0,0,0,44,0,44,CT,153
1359,Middle,REZ,0,2,-2,108,238,-130,T,153
1360,Construction,REZ,0,2,-2,47,200,-153,CT,153
1361,Construction,REZ,3,1,2,290,100,190,T,153
1362,Deep CT Peeking Towards B Site,REZ,0,2,-2,43,200,-157,CT,153
1363,Deep CT Peeking Towards B Site,REZ,0,0,0,0,66,-66,T,153
1364,Dark,REZ,0,1,-1,0,100,-100,CT,153
1365,Dark,REZ,0,0,0,26,0,26,T,153
1366,Chokepoint Entering B,REZ,0,1,-1,140,96,44,CT,153
1367,Chokepoint Entering B,REZ,6,2,4,344,254,90,T,153
1368,CT Outside Construction,REZ,0,1,-1,0,100,-100,CT,153
1369,CT Outside Construction,REZ,0,0,0,0,0,0,T,153
1370,CT Arch,REZ,0,1,-1,0,100,-100,CT,153
1371,CT Arch,REZ,1,0,1,0,0,0,T,153
1372,Pit,REZ,0,0,0,1,86,-85,CT,153
1373,Pit,REZ,1,1,0,100,91,9,T,153
1374,CT Peek Towards B Choke,REZ,2,2,0,168,226,-58,CT,153
1375,CT Peek Towards B Choke,REZ,0,0,0,44,0,44,T,153
1376,A Site,REZ,0,1,-1,169,127,42,CT,153
1377,A Site,REZ,1,2,-1,92,130,-38,T,153
1378,Default Plant A Site,REZ,1,0,1,46,0,46,CT,153
1379,Default Plant A Site,REZ,1,2,-1,152,188,-36,T,153
1380,Quad Box,REZ,0,0,0,0,0,0,CT,153
1381,Quad Box,REZ,0,1,-1,42,100,-58,T,153
1382,Top Balcony ,REZ,2,2,0,203,200,3,CT,153
1383,Top Balcony ,REZ,0,0,0,0,15,-15,T,153
1384,Boiler Peek to Mid,REZ,1,1,0,208,100,108,CT,153
1385,Boiler Peek to Mid,REZ,2,2,0,129,278,-149,T,153
1386,Pit Peek Towards Lane,REZ,1,0,1,127,18,109,CT,153
1387,Pit Peek Towards Lane,REZ,0,0,0,0,0,0,T,153
1388,CT Banana Sandbangs,REZ,2,1,1,192,100,92,CT,153
1389,CT Banana Sandbangs,REZ,0,1,-1,0,12,-12,T,153
1390,Library,REZ,0,2,-2,56,200,-144,CT,153
1391,Library,REZ,0,0,0,0,0,0,T,153
1392,B Site,REZ,3,0,3,274,110,164,CT,153
1393,B Site,REZ,0,2,-2,27,190,-163,T,153
1394,B Site Cross for T's Exposed to CT and Quad,REZ,1,0,1,100,0,100,CT,153
1395,B Site Cross for T's Exposed to CT and Quad,REZ,2,2,0,242,246,-4,T,153
1396,Lane Behind Pillar,REZ,0,0,0,47,27,20,CT,153
1397,Lane Behind Pillar,REZ,0,0,0,0,8,-8,T,153
1398,Top Graveyard,REZ,1,2,-1,55,95,-40,CT,153
1399,Top Graveyard,REZ,0,0,0,0,0,0,T,153
1400,Deep Apps Past Hallway,REZ,1,1,0,100,179,-79,CT,153
1401,Deep Apps Past Hallway,REZ,0,0,0,0,28,-28,T,153
1402,A Site Behind Default Boxes,REZ,3,1,2,366,100,266,CT,153
1403,A Site Behind Default Boxes,REZ,1,0,1,100,26,74,T,153
1404,1st Oranges,REZ,0,1,-1,87,48,39,CT,153
1405,1st Oranges,REZ,0,0,0,0,0,0,T,153
1406,Chokepoint Entrance onto A site from Library Side,REZ,2,0,2,169,78,91,CT,153
1407,Chokepoint Entrance onto A site from Library Side,REZ,1,0,1,100,85,15,T,153
1408,A Site Right Side Middle Pillar,REZ,1,1,0,149,100,49,CT,153
1409,A Site Right Side Middle Pillar,REZ,0,1,-1,0,124,-124,T,153
1410,Front Coffins,REZ,0,0,0,0,0,0,CT,153
1411,Front Coffins,REZ,0,2,-2,0,149,-149,T,153
1412,Arch Side CT Corner Peeking Towards Top Mid,REZ,0,0,0,0,22,-22,CT,153
1413,Arch Side CT Corner Peeking Towards Top Mid,REZ,0,0,0,0,0,0,T,153
1414,A Site Left Side Middle Boxes,REZ,0,0,0,73,44,29,CT,153
1415,A Site Left Side Middle Boxes,REZ,0,0,0,0,0,0,T,153
1416,2nd Oranges,REZ,0,0,0,0,0,0,CT,153
1417,2nd Oranges,REZ,2,1,1,116,18,98,T,153
1418,CT Banana Sandbags Right Corner,REZ,1,0,1,118,12,106,CT,153
1419,CT Banana Sandbags Right Corner,REZ,0,0,0,0,0,0,T,153
1420,Logs,REZ,0,0,0,0,0,0,CT,153
1421,Logs,REZ,0,1,-1,0,142,-142,T,153
1422,A Bombsite Back Site,REZ,0,0,0,0,0,0,CT,153
1423,A Bombsite Back Site,REZ,1,1,0,100,114,-14,T,153
1424,Top Coffins,REZ,0,0,0,0,0,0,CT,153
1425,Top Coffins,REZ,0,0,0,0,0,0,T,153
1426,Grill,REZ,0,0,0,0,0,0,CT,153
1427,Grill,REZ,0,1,-1,85,33,52,T,153
1428,Apps T Side Stairs,REZ,0,0,0,8,0,8,CT,153
1429,Apps T Side Stairs,REZ,1,1,0,258,170,88,T,153
1430,Underpass,REZ,0,0,0,0,0,0,CT,153
1431,Underpass,REZ,0,1,-1,22,221,-199,T,153
1432,CT Outside Kitchen,REZ,0,0,0,0,0,0,CT,153
1433,CT Outside Kitchen,REZ,0,1,-1,0,100,-100,T,153
1434,Right Side Quadbox Peek for a CT,REZ,0,0,0,0,0,0,CT,153
1435,Right Side Quadbox Peek for a CT,REZ,0,0,0,27,0,27,T,153
1436,T Ramp Peeking Towards Mid,REZ,0,0,0,0,0,0,CT,153
1437,T Ramp Peeking Towards Mid,REZ,0,0,0,30,89,-59,T,153
1438,Apps Hallway,REZ,0,0,0,0,1,-1,CT,153
1439,Apps Hallway,REZ,0,1,-1,34,105,-71,T,153
1440,Top Hay Bales,REZ,0,0,0,0,0,0,CT,153
1441,Top Hay Bales,REZ,1,0,1,53,11,42,T,153
1442,LowerMid,REZ,0,0,0,0,0,0,CT,153
1443,LowerMid,REZ,1,0,1,21,0,21,T,153
1444,Bottom Graveyard,REZ,0,0,0,0,0,0,CT,153
1445,Bottom Graveyard,REZ,0,1,-1,26,100,-74,T,153
1446,Graveyard Stairs,REZ,0,0,0,0,0,0,CT,153
1447,Graveyard Stairs,REZ,2,1,1,271,31,240,T,153
1448,BackAlley,REZ,0,0,0,0,0,0,CT,153
1449,BackAlley,REZ,0,1,-1,0,27,-27,T,153
1450,TSpawn,REZ,2,0,2,151,50,101,CT,153
1451,TSpawn,REZ,0,0,0,0,0,0,T,153
1452,Outside Library,REZ,0,0,0,0,0,0,CT,153
1453,Outside Library,REZ,1,0,1,100,0,100,T,153
1454,Left Side Quadbox Peek for a CT,REZ,0,0,0,0,0,0,CT,153
1455,Left Side Quadbox Peek for a CT,REZ,0,1,-1,0,100,-100,T,153
1456,Arch Side Cubby,REZ,0,1,-1,0,100,-100,CT,153
1457,Arch Side Cubby,REZ,0,0,0,0,0,0,T,153
1458,Apartments,REZ,0,0,0,0,0,0,CT,153
1459,Apartments,REZ,0,0,0,0,0,0,T,153
1460,Back Alley,REZ,0,1,-1,0,100,-100,CT,153
1461,Back Alley,REZ,0,0,0,0,0,0,T,153
1462,CT Banana Half Wall Side,Plopski,3,2,1,404,318,86,CT,153
1463,CT Banana Half Wall Side,Plopski,6,8,-2,905,900,5,T,153
1464,Chokepoint Entering B,Plopski,2,4,-2,626,374,252,CT,153
1465,Chokepoint Entering B,Plopski,1,4,-3,417,527,-110,T,153
1466,Banana,Plopski,4,3,1,182,342,-160,CT,153
1467,Banana,Plopski,7,6,1,1238,1220,18,T,153
1468,CT Banana Sandbangs,Plopski,7,2,5,835,449,386,CT,153
1469,CT Banana Sandbangs,Plopski,1,2,-1,211,183,28,T,153
1470,CT Peek Towards B Choke,Plopski,3,1,2,342,111,231,CT,153
1471,CT Peek Towards B Choke,Plopski,4,2,2,324,156,168,T,153
1472,Lane Side,Plopski,0,4,-4,48,265,-217,CT,153
1473,Lane Side,Plopski,2,2,0,342,314,28,T,153
1474,A Bombsite Close Left,Plopski,0,0,0,0,0,0,CT,153
1475,A Bombsite Close Left,Plopski,2,6,-4,280,354,-74,T,153
1476,CT Banana Barrels,Plopski,2,1,1,315,135,180,CT,153
1477,CT Banana Barrels,Plopski,0,1,-1,0,59,-59,T,153
1478,2nd Oranges,Plopski,2,3,-1,314,286,28,CT,153
1479,2nd Oranges,Plopski,1,1,0,130,100,30,T,153
1480,Logs,Plopski,1,3,-2,181,205,-24,CT,153
1481,Logs,Plopski,3,1,2,395,238,157,T,153
1482,Grill,Plopski,0,0,0,0,0,0,CT,153
1483,Grill,Plopski,1,0,1,107,21,86,T,153
1484,Top Balcony ,Plopski,0,0,0,0,0,0,CT,153
1485,Top Balcony ,Plopski,1,1,0,100,100,0,T,153
1486,Chokepoint Entrance onto A site from Library Side,Plopski,2,0,2,194,0,194,CT,153
1487,Chokepoint Entrance onto A site from Library Side,Plopski,0,1,-1,0,90,-90,T,153
1488,B Site Cross for T's Exposed to CT and Quad,Plopski,0,0,0,9,0,9,CT,153
1489,B Site Cross for T's Exposed to CT and Quad,Plopski,1,2,-1,109,234,-125,T,153
1490,B Site,Plopski,6,2,4,398,124,274,CT,153
1491,B Site,Plopski,1,1,0,137,108,29,T,153
1492,A Site,Plopski,0,1,-1,23,100,-77,CT,153
1493,A Site,Plopski,1,2,-1,26,102,-76,T,153
1494,CT Banana Sandbags Right Corner,Plopski,2,1,1,216,150,66,CT,153
1495,CT Banana Sandbags Right Corner,Plopski,0,1,-1,22,95,-73,T,153
1496,Top Coffins,Plopski,2,2,0,253,200,53,CT,153
1497,Top Coffins,Plopski,0,0,0,0,0,0,T,153
1498,Behind Coffins Playing the B Site Cross,Plopski,1,0,1,185,0,185,CT,153
1499,Behind Coffins Playing the B Site Cross,Plopski,0,1,-1,0,100,-100,T,153
1500,1st Oranges,Plopski,7,3,4,659,324,335,CT,153
1501,1st Oranges,Plopski,0,0,0,0,0,0,T,153
1502,Top Mid Chokepoint,Plopski,0,1,-1,0,100,-100,CT,153
1503,Top Mid Chokepoint,Plopski,1,2,-1,33,274,-241,T,153
1504,Bottom Mid Banana,Plopski,0,1,-1,16,89,-73,CT,153
1505,Bottom Mid Banana,Plopski,0,0,0,28,4,24,T,153
1506,Dark,Plopski,0,0,0,0,0,0,CT,153
1507,Dark,Plopski,0,3,-3,44,147,-103,T,153
1508,CT Boost,Plopski,0,0,0,7,51,-44,CT,153
1509,CT Boost,Plopski,0,0,0,0,0,0,T,153
1510,Quad Box,Plopski,0,1,-1,0,75,-75,CT,153
1511,Quad Box,Plopski,1,0,1,41,0,41,T,153
1512,Top Mid Lane Side ,Plopski,0,0,0,0,45,-45,CT,153
1513,Top Mid Lane Side ,Plopski,0,2,-2,0,214,-214,T,153
1514,A Bombsite Back Site,Plopski,0,0,0,0,0,0,CT,153
1515,A Bombsite Back Site,Plopski,1,0,1,100,69,31,T,153
1516,Bottom Mid exposed to Top Mid,Plopski,0,0,0,0,0,0,CT,153
1517,Bottom Mid exposed to Top Mid,Plopski,0,1,-1,0,100,-100,T,153
1518,Apps T Side Stairs,Plopski,0,0,0,0,0,0,CT,153
1519,Apps T Side Stairs,Plopski,0,0,0,0,9,-9,T,153
1520,Pit Below Balcony,Plopski,0,0,0,0,0,0,CT,153
1521,Pit Below Balcony,Plopski,0,0,0,0,0,0,T,153
1522,T Ramp Peeking Towards Mid,Plopski,0,0,0,0,0,0,CT,153
1523,T Ramp Peeking Towards Mid,Plopski,0,0,0,44,112,-68,T,153
1524,Behind B Site Back Pillar,Plopski,0,0,0,0,0,0,CT,153
1525,Behind B Site Back Pillar,Plopski,1,1,0,134,73,61,T,153
1526,Lane Patio,Plopski,0,1,-1,0,100,-100,CT,153
1527,Lane Patio,Plopski,0,0,0,0,0,0,T,153
1528,A Site Behind Default Boxes,Plopski,0,0,0,0,0,0,CT,153
1529,A Site Behind Default Boxes,Plopski,1,0,1,19,0,19,T,153
1530,Front Coffins,Plopski,0,0,0,0,0,0,CT,153
1531,Front Coffins,Plopski,0,2,-2,0,164,-164,T,153
1532,CT Outside Arch,Plopski,1,2,-1,139,200,-61,CT,153
1533,CT Outside Arch,Plopski,0,0,0,0,0,0,T,153
1534,A Site Right Side Middle Pillar,Plopski,0,0,0,0,0,0,CT,153
1535,A Site Right Side Middle Pillar,Plopski,0,1,-1,0,100,-100,T,153
1536,CT Spawn ,Plopski,0,1,-1,99,100,-1,CT,153
1537,CT Spawn ,Plopski,0,0,0,0,0,0,T,153
1538,SecondMid,Plopski,0,1,-1,0,129,-129,CT,153
1539,SecondMid,Plopski,0,0,0,0,0,0,T,153
1540,CT Outside Kitchen,Plopski,0,1,-1,0,80,-80,CT,153
1541,CT Outside Kitchen,Plopski,0,0,0,0,0,0,T,153
1542,A Site Left Side Middle Boxes,Plopski,0,1,-1,19,100,-81,CT,153
1543,A Site Left Side Middle Boxes,Plopski,0,0,0,0,0,0,T,153
1544,Underpass,Plopski,0,0,0,0,0,0,CT,153
1545,Underpass,Plopski,0,0,0,0,0,0,T,153
1546,Default Plant A Site,Plopski,0,0,0,0,0,0,CT,153
1547,Default Plant A Site,Plopski,1,1,0,117,72,45,T,153
1548,Lane Peek Towards Top Mid,Plopski,0,0,0,0,0,0,CT,153
1549,Lane Peek Towards Top Mid,Plopski,0,1,-1,0,101,-101,T,153
1550,Arch Side,Plopski,0,0,0,0,0,0,CT,153
1551,Arch Side,Plopski,1,1,0,73,100,-27,T,153
1552,Top Mid Arch Side,Plopski,0,1,-1,91,100,-9,CT,153
1553,Top Mid Arch Side,Plopski,0,0,0,0,0,0,T,153
1554,Middle,Plopski,1,0,1,100,11,89,CT,153
1555,Middle,Plopski,0,0,0,0,45,-45,T,153
1556,Left Side Quadbox Peek for a CT,Plopski,0,0,0,0,0,0,CT,153
1557,Left Side Quadbox Peek for a CT,Plopski,0,0,0,0,0,0,T,153
1558,Library,Plopski,0,1,-1,0,100,-100,CT,153
1559,Library,Plopski,0,0,0,0,0,0,T,153
1560,Pit,Plopski,0,0,0,0,0,0,CT,153
1561,Pit,Plopski,0,0,0,78,30,48,T,153
1562,CT Arch,Plopski,0,0,0,0,0,0,CT,153
1563,CT Arch,Plopski,0,0,0,0,0,0,T,153
1564,CT Near Well,Plopski,0,0,0,24,24,0,CT,153
1565,CT Near Well,Plopski,0,1,-1,0,56,-56,T,153
1566,Lane Side,hampus,2,2,0,210,175,35,CT,153
1567,Lane Side,hampus,3,4,-1,599,294,305,T,153
1568,CT Banana Half Wall Side,hampus,0,2,-2,186,238,-52,CT,153
1569,CT Banana Half Wall Side,hampus,3,6,-3,246,691,-445,T,153
1570,Banana,hampus,3,1,2,394,161,233,CT,153
1571,Banana,hampus,4,6,-2,496,1017,-521,T,153
1572,B Site,hampus,2,4,-2,374,400,-26,CT,153
1573,B Site,hampus,1,1,0,59,21,38,T,153
1574,Top Balcony ,hampus,1,1,0,14,69,-55,CT,153
1575,Top Balcony ,hampus,5,6,-1,409,717,-308,T,153
1576,CT Banana Sandbangs,hampus,0,2,-2,111,261,-150,CT,153
1577,CT Banana Sandbangs,hampus,4,1,3,373,143,230,T,153
1578,Chokepoint Entering B,hampus,2,5,-3,372,510,-138,CT,153
1579,Chokepoint Entering B,hampus,3,4,-1,194,363,-169,T,153
1580,Middle,hampus,0,2,-2,51,182,-131,CT,153
1581,Middle,hampus,3,3,0,356,265,91,T,153
1582,A Site,hampus,0,1,-1,0,46,-46,CT,153
1583,A Site,hampus,2,1,1,156,115,41,T,153
1584,CT Banana Barrels,hampus,2,4,-2,828,507,321,CT,153
1585,CT Banana Barrels,hampus,0,1,-1,0,48,-48,T,153
1586,Top Mid Lane Side ,hampus,0,2,-2,0,200,-200,CT,153
1587,Top Mid Lane Side ,hampus,0,2,-2,80,200,-120,T,153
1588,CT Peek Towards B Choke,hampus,2,3,-1,292,397,-105,CT,153
1589,CT Peek Towards B Choke,hampus,2,0,2,208,158,50,T,153
1590,Grill,hampus,1,1,0,7,82,-75,CT,153
1591,Grill,hampus,0,4,-4,81,333,-252,T,153
1592,Top Coffins,hampus,2,2,0,254,122,132,CT,153
1593,Top Coffins,hampus,0,0,0,0,0,0,T,153
1594,Top Mid Arch Side,hampus,0,1,-1,0,100,-100,CT,153
1595,Top Mid Arch Side,hampus,0,1,-1,0,100,-100,T,153
1596,Pit Peek Towards Lane,hampus,4,1,3,363,127,236,CT,153
1597,Pit Peek Towards Lane,hampus,3,1,2,314,127,187,T,153
1598,Pit,hampus,0,0,0,0,10,-10,CT,153
1599,Pit,hampus,2,2,0,172,104,68,T,153
1600,Boiler Side Stairs,hampus,0,0,0,0,0,0,CT,153
1601,Boiler Side Stairs,hampus,1,2,-1,44,91,-47,T,153
1602,Arch Side,hampus,0,1,-1,22,100,-78,CT,153
1603,Arch Side,hampus,0,2,-2,27,139,-112,T,153
1604,A Site Behind Middle Boxes/Pillar hidden from Lane,hampus,0,0,0,0,0,0,CT,153
1605,A Site Behind Middle Boxes/Pillar hidden from Lane,hampus,0,0,0,0,0,0,T,153
1606,B Site Cross for T's Exposed to CT and Quad,hampus,0,0,0,0,0,0,CT,153
1607,B Site Cross for T's Exposed to CT and Quad,hampus,2,1,1,147,97,50,T,153
1608,Logs,hampus,0,0,0,0,0,0,CT,153
1609,Logs,hampus,2,3,-1,289,330,-41,T,153
1610,CT Arch,hampus,1,1,0,8,100,-92,CT,153
1611,CT Arch,hampus,0,0,0,0,0,0,T,153
1612,Outside Library,hampus,0,0,0,21,0,21,CT,153
1613,Outside Library,hampus,1,0,1,100,0,100,T,153
1614,Chokepoint Entrance onto A site from Library Side,hampus,1,1,0,167,124,43,CT,153
1615,Chokepoint Entrance onto A site from Library Side,hampus,0,1,-1,0,172,-172,T,153
1616,1st Oranges,hampus,0,0,0,0,0,0,CT,153
1617,1st Oranges,hampus,0,0,0,0,0,0,T,153
1618,T Ramp Peeking Towards Mid,hampus,0,0,0,0,0,0,CT,153
1619,T Ramp Peeking Towards Mid,hampus,1,1,0,145,145,0,T,153
1620,Default Plant A Site,hampus,0,0,0,0,0,0,CT,153
1621,Default Plant A Site,hampus,1,1,0,127,80,47,T,153
1622,Deep Apps Past Hallway,hampus,0,0,0,0,0,0,CT,153
1623,Deep Apps Past Hallway,hampus,1,2,-1,198,280,-82,T,153
1624,CT Banana Sandbags Right Corner,hampus,2,0,2,30,10,20,CT,153
1625,CT Banana Sandbags Right Corner,hampus,0,0,0,0,38,-38,T,153
1626,CT Outside Arch,hampus,0,1,-1,44,33,11,CT,153
1627,CT Outside Arch,hampus,0,0,0,0,0,0,T,153
1628,Behind B Site Back Pillar,hampus,0,0,0,0,0,0,CT,153
1629,Behind B Site Back Pillar,hampus,0,0,0,0,0,0,T,153
1630,Apps T Side Stairs,hampus,0,0,0,26,0,26,CT,153
1631,Apps T Side Stairs,hampus,0,1,-1,0,106,-106,T,153
1632,CT Outside Construction,hampus,0,1,-1,0,32,-32,CT,153
1633,CT Outside Construction,hampus,0,0,0,0,0,0,T,153
1634,Construction,hampus,2,1,1,200,100,100,CT,153
1635,Construction,hampus,0,0,0,0,0,0,T,153
1636,TSpawn,hampus,0,0,0,0,0,0,CT,153
1637,TSpawn,hampus,0,1,-1,0,100,-100,T,153
1638,T Ramp Ledge,hampus,0,0,0,0,0,0,CT,153
1639,T Ramp Ledge,hampus,0,1,-1,0,100,-100,T,153
1640,Quad Box,hampus,1,1,0,50,69,-19,CT,153
1641,Quad Box,hampus,0,0,0,42,0,42,T,153
1642,Next to Library Cubby,hampus,0,1,-1,54,100,-46,CT,153
1643,Next to Library Cubby,hampus,0,0,0,0,0,0,T,153
1644,CT Outside Kitchen,hampus,1,1,0,185,100,85,CT,153
1645,CT Outside Kitchen,hampus,0,0,0,0,0,0,T,153
1646,Top Hay Bales,hampus,0,0,0,0,0,0,CT,153
1647,Top Hay Bales,hampus,0,1,-1,0,57,-57,T,153
1648,Left Side Quadbox Peek for a CT,hampus,0,0,0,0,0,0,CT,153
1649,Left Side Quadbox Peek for a CT,hampus,0,1,-1,0,5,-5,T,153
1650,Lane Peek Towards Top Mid,hampus,0,0,0,0,0,0,CT,153
1651,Lane Peek Towards Top Mid,hampus,0,0,0,0,0,0,T,153
1652,2nd Oranges,hampus,2,1,1,309,100,209,CT,153
1653,2nd Oranges,hampus,0,0,0,0,0,0,T,153
1654,A Bombsite Back Site,hampus,0,0,0,0,0,0,CT,153
1655,A Bombsite Back Site,hampus,0,0,0,0,0,0,T,153
1656,Right Side Quadbox Peek for a CT,hampus,1,1,0,194,131,63,CT,153
1657,Right Side Quadbox Peek for a CT,hampus,0,0,0,0,0,0,T,153
1658,CT Tree,hampus,0,0,0,0,0,0,CT,153
1659,CT Tree,hampus,0,0,0,0,0,0,T,153
1660,Bottom Mid exposed to Top Mid,hampus,0,0,0,54,18,36,CT,153
1661,Bottom Mid exposed to Top Mid,hampus,1,0,1,90,13,77,T,153
1662,A Bombsite Close Left,hampus,0,0,0,0,0,0,CT,153
1663,A Bombsite Close Left,hampus,0,0,0,0,0,0,T,153
1664,Behind Coffins Playing the B Site Cross,hampus,2,0,2,56,0,56,CT,153
1665,Behind Coffins Playing the B Site Cross,hampus,0,0,0,0,0,0,T,153
1666,Top Mid Chokepoint,hampus,0,0,0,0,0,0,CT,153
1667,Top Mid Chokepoint,hampus,0,0,0,83,65,18,T,153
1668,Bottom Mid Banana,hampus,0,0,0,0,0,0,CT,153
1669,Bottom Mid Banana,hampus,1,0,1,16,22,-6,T,153
1670,Deep CT Peeking Towards B Site,hampus,0,0,0,22,0,22,CT,153
1671,Deep CT Peeking Towards B Site,hampus,0,0,0,0,0,0,T,153
1672,Apartments Hallway Peek from T Side,hampus,0,0,0,0,0,0,CT,153
1673,Apartments Hallway Peek from T Side,hampus,0,1,-1,8,100,-92,T,153
1674,CT Boost,hampus,0,0,0,0,18,-18,CT,153
1675,CT Boost,hampus,0,1,-1,0,19,-19,T,153
1676,Pit Below Balcony,hampus,0,0,0,84,27,57,CT,153
1677,Pit Below Balcony,hampus,5,1,4,378,62,316,T,153
1678,Apps Hallway,hampus,0,0,0,0,0,0,CT,153
1679,Apps Hallway,hampus,1,1,0,120,186,-66,T,153
1680,A Site Right Side Middle Pillar,hampus,0,0,0,0,0,0,CT,153
1681,A Site Right Side Middle Pillar,hampus,0,0,0,0,0,0,T,153
1682,Apartments,hampus,0,0,0,0,0,0,CT,153
1683,Apartments,hampus,0,0,0,0,0,0,T,153
1684,Chokepoint Entering B,CeRq,0,0,0,0,0,0,CT,138
1685,Chokepoint Entering B,CeRq,5,4,1,387,522,-135,T,138
1686,B Site,CeRq,0,2,-2,0,177,-177,CT,138
1687,B Site,CeRq,4,3,1,348,371,-23,T,138
1688,Lane Side,CeRq,0,0,0,44,51,-7,CT,138
1689,Lane Side,CeRq,6,5,1,619,488,131,T,138
1690,Banana,CeRq,0,0,0,0,0,0,CT,138
1691,Banana,CeRq,3,5,-2,486,685,-199,T,138
1692,Arch Side,CeRq,2,2,0,372,309,63,CT,138
1693,Arch Side,CeRq,2,1,1,142,168,-26,T,138
1694,CT Banana Half Wall Side,CeRq,0,0,0,0,22,-22,CT,138
1695,CT Banana Half Wall Side,CeRq,1,5,-4,213,411,-198,T,138
1696,Construction,CeRq,1,2,-1,107,200,-93,CT,138
1697,Construction,CeRq,0,1,-1,5,83,-78,T,138
1698,Pit Below Balcony,CeRq,0,0,0,0,0,0,CT,138
1699,Pit Below Balcony,CeRq,1,0,1,100,16,84,T,138
1700,2nd Oranges,CeRq,0,0,0,0,0,0,CT,138
1701,2nd Oranges,CeRq,6,2,4,425,251,174,T,138
1702,T Ramp Peeking Towards Mid,CeRq,0,0,0,0,0,0,CT,138
1703,T Ramp Peeking Towards Mid,CeRq,1,3,-2,100,270,-170,T,138
1704,CT Outside Construction,CeRq,1,3,-2,101,234,-133,CT,138
1705,CT Outside Construction,CeRq,0,0,0,0,0,0,T,138
1706,Top Mid Lane Side ,CeRq,2,1,1,343,100,243,CT,138
1707,Top Mid Lane Side ,CeRq,2,1,1,146,141,5,T,138
1708,CT Peek Towards B Choke,CeRq,2,3,-1,181,231,-50,CT,138
1709,CT Peek Towards B Choke,CeRq,1,0,1,74,2,72,T,138
1710,Chokepoint Entrance onto A site from Library Side,CeRq,1,3,-2,170,347,-177,CT,138
1711,Chokepoint Entrance onto A site from Library Side,CeRq,0,0,0,0,0,0,T,138
1712,Library,CeRq,3,3,0,372,300,72,CT,138
1713,Library,CeRq,0,0,0,0,0,0,T,138
1714,A Site Behind Middle Boxes/Pillar hidden from Lane,CeRq,6,4,2,345,433,-88,CT,138
1715,A Site Behind Middle Boxes/Pillar hidden from Lane,CeRq,0,0,0,0,0,0,T,138
1716,Top Mid Chokepoint,CeRq,0,0,0,0,0,0,CT,138
1717,Top Mid Chokepoint,CeRq,1,2,-1,97,314,-217,T,138
1718,A Site Right Side Middle Pillar,CeRq,0,0,0,0,0,0,CT,138
1719,A Site Right Side Middle Pillar,CeRq,0,0,0,0,0,0,T,138
1720,Top Mid Arch Side,CeRq,1,1,0,143,125,18,CT,138
1721,Top Mid Arch Side,CeRq,1,0,1,100,55,45,T,138
1722,Deep CT Peeking Towards B Site,CeRq,3,1,2,327,192,135,CT,138
1723,Deep CT Peeking Towards B Site,CeRq,1,0,1,100,0,100,T,138
1724,Behind Coffins Playing the B Site Cross,CeRq,0,0,0,0,0,0,CT,138
1725,Behind Coffins Playing the B Site Cross,CeRq,1,0,1,66,92,-26,T,138
1726,B Site Cross for T's Exposed to CT and Quad,CeRq,0,0,0,0,0,0,CT,138
1727,B Site Cross for T's Exposed to CT and Quad,CeRq,0,1,-1,0,38,-38,T,138
1728,Top Balcony ,CeRq,0,0,0,0,0,0,CT,138
1729,Top Balcony ,CeRq,1,1,0,35,68,-33,T,138
1730,Default Plant A Site,CeRq,0,0,0,0,0,0,CT,138
1731,Default Plant A Site,CeRq,0,0,0,1,0,1,T,138
1732,Pit,CeRq,0,0,0,0,0,0,CT,138
1733,Pit,CeRq,0,0,0,0,14,-14,T,138
1734,Quad Box,CeRq,0,0,0,0,0,0,CT,138
1735,Quad Box,CeRq,1,0,1,100,43,57,T,138
1736,Pit Peek Towards Lane,CeRq,0,0,0,0,0,0,CT,138
1737,Pit Peek Towards Lane,CeRq,0,0,0,0,0,0,T,138
1738,A Bombsite Close Left,CeRq,4,0,4,288,41,247,CT,138
1739,A Bombsite Close Left,CeRq,0,1,-1,8,32,-24,T,138
1740,Front Coffins,CeRq,0,0,0,0,0,0,CT,138
1741,Front Coffins,CeRq,1,0,1,46,0,46,T,138
1742,A Site,CeRq,3,1,2,293,142,151,CT,138
1743,A Site,CeRq,0,0,0,44,0,44,T,138
1744,Top Hay Bales,CeRq,0,0,0,0,0,0,CT,138
1745,Top Hay Bales,CeRq,0,1,-1,0,99,-99,T,138
1746,Middle,CeRq,0,1,-1,78,87,-9,CT,138
1747,Middle,CeRq,2,0,2,166,137,29,T,138
1748,CT Outside Arch,CeRq,0,0,0,0,0,0,CT,138
1749,CT Outside Arch,CeRq,0,1,-1,0,93,-93,T,138
1750,CT Arch,CeRq,0,0,0,0,0,0,CT,138
1751,CT Arch,CeRq,2,1,1,204,59,145,T,138
1752,CT Banana Sandbangs,CeRq,0,0,0,0,0,0,CT,138
1753,CT Banana Sandbangs,CeRq,2,0,2,175,36,139,T,138
1754,Dumpster,CeRq,0,1,-1,0,18,-18,CT,138
1755,Dumpster,CeRq,0,0,0,0,173,-173,T,138
1756,A Site Left Side Middle Boxes,CeRq,0,1,-1,16,115,-99,CT,138
1757,A Site Left Side Middle Boxes,CeRq,0,0,0,0,0,0,T,138
1758,Left Side Quadbox Peek for a CT,CeRq,0,0,0,0,0,0,CT,138
1759,Left Side Quadbox Peek for a CT,CeRq,0,0,0,0,0,0,T,138
1760,Dark,CeRq,0,0,0,0,0,0,CT,138
1761,Dark,CeRq,0,0,0,0,0,0,T,138
1762,Next to Library Cubby,CeRq,1,0,1,94,0,94,CT,138
1763,Next to Library Cubby,CeRq,0,0,0,0,0,0,T,138
1764,Lane Peek Towards Top Mid,CeRq,1,1,0,178,100,78,CT,138
1765,Lane Peek Towards Top Mid,CeRq,0,0,0,0,0,0,T,138
1766,Underpass,CeRq,0,0,0,0,0,0,CT,138
1767,Underpass,CeRq,1,1,0,223,131,92,T,138
1768,Lane Behind Pillar,CeRq,0,1,-1,0,87,-87,CT,138
1769,Lane Behind Pillar,CeRq,0,0,0,0,0,0,T,138
1770,TopofMid,CeRq,1,1,0,100,100,0,CT,138
1771,TopofMid,CeRq,0,0,0,0,0,0,T,138
1772,Top Coffins,CeRq,0,0,0,0,0,0,CT,138
1773,Top Coffins,CeRq,0,1,-1,0,8,-8,T,138
1774,Boiler Peek to Mid,CeRq,0,0,0,0,0,0,CT,138
1775,Boiler Peek to Mid,CeRq,0,0,0,34,9,25,T,138
1776,Bottom Graveyard,CeRq,0,0,0,0,0,0,CT,138
1777,Bottom Graveyard,CeRq,0,0,0,0,7,-7,T,138
1778,Bottom Mid exposed to Top Mid,CeRq,0,0,0,0,0,0,CT,138
1779,Bottom Mid exposed to Top Mid,CeRq,1,0,1,97,9,88,T,138
1780,Bottom Mid Banana,CeRq,0,0,0,0,0,0,CT,138
1781,Bottom Mid Banana,CeRq,1,1,0,73,106,-33,T,138
1782,SecondMid,CeRq,0,0,0,63,19,44,CT,138
1783,SecondMid,CeRq,0,0,0,0,2,-2,T,138
1784,Apartments,CeRq,0,0,0,53,0,53,CT,138
1785,Apartments,CeRq,0,1,-1,2,67,-65,T,138
1786,Graveyard Stairs,CeRq,0,0,0,0,13,-13,CT,138
1787,Graveyard Stairs,CeRq,1,1,0,113,107,6,T,138
1788,Apartments Hallway Peek from T Side,CeRq,0,0,0,0,0,0,CT,138
1789,Apartments Hallway Peek from T Side,CeRq,0,0,0,2,0,2,T,138
1790,Outside Library,CeRq,1,0,1,53,0,53,CT,138
1791,Outside Library,CeRq,1,0,1,72,6,66,T,138
1792,Boiler Side Stairs,CeRq,0,0,0,0,26,-26,CT,138
1793,Boiler Side Stairs,CeRq,1,0,1,92,15,77,T,138
1794,A Site Behind Default Boxes,CeRq,1,0,1,73,0,73,CT,138
1795,A Site Behind Default Boxes,CeRq,0,1,-1,0,57,-57,T,138
1796,Arch Side CT Corner Peeking Towards Top Mid,CeRq,1,0,1,124,0,124,CT,138
1797,Arch Side CT Corner Peeking Towards Top Mid,CeRq,0,0,0,0,0,0,T,138
1798,Deep Apps Past Hallway,CeRq,0,1,-1,15,100,-85,CT,138
1799,Deep Apps Past Hallway,CeRq,1,0,1,100,0,100,T,138
1800,Arch Side Cubby,CeRq,0,0,0,0,0,0,CT,138
1801,Arch Side Cubby,CeRq,0,0,0,0,0,0,T,138
1802,Top Graveyard,CeRq,1,0,1,40,0,40,CT,138
1803,Top Graveyard,CeRq,0,0,0,0,0,0,T,138
1804,CT Peek Towards B Choke,CRUC1AL,2,5,-3,382,500,-118,CT,133
1805,CT Peek Towards B Choke,CRUC1AL,0,0,0,16,2,14,T,133
1806,Arch Side,CRUC1AL,5,4,1,528,540,-12,CT,133
1807,Arch Side,CRUC1AL,3,0,3,347,55,292,T,133
1808,Top Mid Chokepoint,CRUC1AL,1,2,-1,126,200,-74,CT,133
1809,Top Mid Chokepoint,CRUC1AL,1,4,-3,151,452,-301,T,133
1810,Lane Side,CRUC1AL,1,1,0,100,62,38,CT,133
1811,Lane Side,CRUC1AL,2,5,-3,312,318,-6,T,133
1812,Banana,CRUC1AL,0,0,0,0,0,0,CT,133
1813,Banana,CRUC1AL,0,5,-5,77,506,-429,T,133
1814,Top Mid Lane Side ,CRUC1AL,1,4,-3,172,404,-232,CT,133
1815,Top Mid Lane Side ,CRUC1AL,2,2,0,186,219,-33,T,133
1816,B Site,CRUC1AL,2,1,1,118,100,18,CT,133
1817,B Site,CRUC1AL,2,4,-2,269,489,-220,T,133
1818,Chokepoint Entering B,CRUC1AL,1,2,-1,74,174,-100,CT,133
1819,Chokepoint Entering B,CRUC1AL,3,1,2,251,94,157,T,133
1820,Top Mid Arch Side,CRUC1AL,4,1,3,333,100,233,CT,133
1821,Top Mid Arch Side,CRUC1AL,0,0,0,62,35,27,T,133
1822,Behind Coffins Playing the B Site Cross,CRUC1AL,0,1,-1,0,22,-22,CT,133
1823,Behind Coffins Playing the B Site Cross,CRUC1AL,0,0,0,0,3,-3,T,133
1824,B Site Cross for T's Exposed to CT and Quad,CRUC1AL,1,0,1,100,0,100,CT,133
1825,B Site Cross for T's Exposed to CT and Quad,CRUC1AL,2,1,1,146,110,36,T,133
1826,SecondMid,CRUC1AL,0,0,0,0,0,0,CT,133
1827,SecondMid,CRUC1AL,1,2,-1,140,254,-114,T,133
1828,Chokepoint Entrance onto A site from Library Side,CRUC1AL,2,2,0,199,140,59,CT,133
1829,Chokepoint Entrance onto A site from Library Side,CRUC1AL,1,0,1,133,22,111,T,133
1830,CT Banana Half Wall Side,CRUC1AL,1,1,0,187,100,87,CT,133
1831,CT Banana Half Wall Side,CRUC1AL,4,2,2,347,200,147,T,133
1832,Middle,CRUC1AL,0,0,0,0,0,0,CT,133
1833,Middle,CRUC1AL,0,1,-1,126,182,-56,T,133
1834,A Bombsite Back Site,CRUC1AL,3,2,1,324,172,152,CT,133
1835,A Bombsite Back Site,CRUC1AL,0,0,0,0,0,0,T,133
1836,2nd Oranges,CRUC1AL,2,1,1,154,97,57,CT,133
1837,2nd Oranges,CRUC1AL,4,0,4,316,0,316,T,133
1838,A Bombsite Close Left,CRUC1AL,1,1,0,118,12,106,CT,133
1839,A Bombsite Close Left,CRUC1AL,0,1,-1,0,27,-27,T,133
1840,A Site Behind Middle Boxes/Pillar hidden from Lane,CRUC1AL,4,1,3,406,208,198,CT,133
1841,A Site Behind Middle Boxes/Pillar hidden from Lane,CRUC1AL,0,0,0,0,0,0,T,133
1842,Library,CRUC1AL,2,0,2,149,0,149,CT,133
1843,Library,CRUC1AL,0,0,0,59,0,59,T,133
1844,Deep CT Peeking Towards B Site,CRUC1AL,0,0,0,0,1,-1,CT,133
1845,Deep CT Peeking Towards B Site,CRUC1AL,0,0,0,0,0,0,T,133
1846,CT Banana Sandbangs,CRUC1AL,0,0,0,0,60,-60,CT,133
1847,CT Banana Sandbangs,CRUC1AL,2,2,0,198,320,-122,T,133
1848,A Site,CRUC1AL,0,1,-1,0,100,-100,CT,133
1849,A Site,CRUC1AL,0,1,-1,43,78,-35,T,133
1850,Deep Apps Past Hallway,CRUC1AL,0,0,0,0,0,0,CT,133
1851,Deep Apps Past Hallway,CRUC1AL,1,0,1,13,0,13,T,133
1852,Grill,CRUC1AL,0,0,0,0,0,0,CT,133
1853,Grill,CRUC1AL,1,0,1,100,0,100,T,133
1854,CT Outside Construction,CRUC1AL,0,0,0,7,0,7,CT,133
1855,CT Outside Construction,CRUC1AL,0,0,0,0,0,0,T,133
1856,CT Boost,CRUC1AL,1,1,0,101,81,20,CT,133
1857,CT Boost,CRUC1AL,0,0,0,0,0,0,T,133
1858,Top Hay Bales,CRUC1AL,0,0,0,0,53,-53,CT,133
1859,Top Hay Bales,CRUC1AL,0,0,0,0,0,0,T,133
1860,Arch Side Cubby,CRUC1AL,1,1,0,288,100,188,CT,133
1861,Arch Side Cubby,CRUC1AL,0,0,0,0,0,0,T,133
1862,Outside Library,CRUC1AL,2,0,2,122,26,96,CT,133
1863,Outside Library,CRUC1AL,0,1,-1,0,73,-73,T,133
1864,CT Spawn ,CRUC1AL,0,2,-2,28,200,-172,CT,133
1865,CT Spawn ,CRUC1AL,0,0,0,0,0,0,T,133
1866,CT Outside Arch,CRUC1AL,0,1,-1,0,100,-100,CT,133
1867,CT Outside Arch,CRUC1AL,0,0,0,2,0,2,T,133
1868,Front Coffins,CRUC1AL,1,0,1,33,0,33,CT,133
1869,Front Coffins,CRUC1AL,0,1,-1,0,100,-100,T,133
1870,Boiler Room,CRUC1AL,0,0,0,0,0,0,CT,133
1871,Boiler Room,CRUC1AL,0,0,0,0,0,0,T,133
1872,Top Balcony ,CRUC1AL,0,0,0,0,0,0,CT,133
1873,Top Balcony ,CRUC1AL,1,0,1,33,0,33,T,133
1874,Boiler Peek to Mid,CRUC1AL,1,0,1,100,0,100,CT,133
1875,Boiler Peek to Mid,CRUC1AL,1,1,0,100,129,-29,T,133
1876,Apps T Side Stairs,CRUC1AL,0,0,0,0,0,0,CT,133
1877,Apps T Side Stairs,CRUC1AL,1,2,-1,100,211,-111,T,133
1878,Construction,CRUC1AL,0,1,-1,8,59,-51,CT,133
1879,Construction,CRUC1AL,0,0,0,0,0,0,T,133
1880,Balcony,CRUC1AL,0,0,0,0,0,0,CT,133
1881,Balcony,CRUC1AL,0,0,0,0,0,0,T,133
1882,Left Side Quadbox Peek for a CT,CRUC1AL,0,0,0,0,0,0,CT,133
1883,Left Side Quadbox Peek for a CT,CRUC1AL,0,0,0,0,0,0,T,133
1884,Underpass,CRUC1AL,0,0,0,0,0,0,CT,133
1885,Underpass,CRUC1AL,0,1,-1,0,100,-100,T,133
1886,Default Plant A Site,CRUC1AL,0,0,0,0,0,0,CT,133
1887,Default Plant A Site,CRUC1AL,0,1,-1,0,68,-68,T,133
1888,Lane Patio,CRUC1AL,0,0,0,0,0,0,CT,133
1889,Lane Patio,CRUC1AL,1,0,1,77,21,56,T,133
1890,CT Outside Kitchen,CRUC1AL,0,0,0,0,0,0,CT,133
1891,CT Outside Kitchen,CRUC1AL,1,0,1,15,0,15,T,133
1892,Lane Peek Towards Top Mid,CRUC1AL,0,1,-1,13,100,-87,CT,133
1893,Lane Peek Towards Top Mid,CRUC1AL,0,0,0,0,0,0,T,133
1894,Dark,CRUC1AL,0,0,0,0,0,0,CT,133
1895,Dark,CRUC1AL,1,1,0,38,100,-62,T,133
1896,Lane Behind Pillar,CRUC1AL,0,1,-1,0,100,-100,CT,133
1897,Lane Behind Pillar,CRUC1AL,0,0,0,0,0,0,T,133
1898,CT Arch,CRUC1AL,0,0,0,0,0,0,CT,133
1899,CT Arch,CRUC1AL,0,1,-1,0,100,-100,T,133
1900,Right Side Quadbox Peek for a CT,CRUC1AL,0,0,0,0,3,-3,CT,133
1901,Right Side Quadbox Peek for a CT,CRUC1AL,4,0,4,394,40,354,T,133
1902,Pit,CRUC1AL,0,0,0,0,0,0,CT,133
1903,Pit,CRUC1AL,0,0,0,0,0,0,T,133
1904,Fountain,CRUC1AL,0,0,0,0,0,0,CT,133
1905,Fountain,CRUC1AL,0,0,0,0,0,0,T,133
1906,Bottom Mid exposed to Top Mid,CRUC1AL,0,0,0,0,0,0,CT,133
1907,Bottom Mid exposed to Top Mid,CRUC1AL,1,1,0,176,30,146,T,133
1908,Apartments,CRUC1AL,1,0,1,100,18,82,CT,133
1909,Apartments,CRUC1AL,0,0,0,0,0,0,T,133
1910,Graveyard Stairs,CRUC1AL,0,0,0,0,0,0,CT,133
1911,Graveyard Stairs,CRUC1AL,0,0,0,0,0,0,T,133
1912,Logs,CRUC1AL,0,0,0,0,0,0,CT,133
1913,Logs,CRUC1AL,0,1,-1,0,84,-84,T,133
1914,CT Speed Way,CRUC1AL,0,1,-1,0,100,-100,CT,133
1915,CT Speed Way,CRUC1AL,0,0,0,0,0,0,T,133
1916,Apps Hallway,CRUC1AL,0,1,-1,0,22,-22,CT,133
1917,Apps Hallway,CRUC1AL,1,0,1,100,117,-17,T,133
1918,A Site Behind Default Boxes,CRUC1AL,1,0,1,100,21,79,CT,133
1919,A Site Behind Default Boxes,CRUC1AL,0,0,0,0,0,0,T,133
1920,1st Oranges,CRUC1AL,0,0,0,0,0,0,CT,133
1921,1st Oranges,CRUC1AL,0,1,-1,0,16,-16,T,133
1922,Top Mid Lane Side ,SANJI,1,0,1,87,160,-73,CT,141
1923,Top Mid Lane Side ,SANJI,2,6,-4,195,632,-437,T,141
1924,Lane Side,SANJI,0,0,0,7,15,-8,CT,141
1925,Lane Side,SANJI,6,2,4,426,335,91,T,141
1926,Top Balcony ,SANJI,3,1,2,270,63,207,CT,141
1927,Top Balcony ,SANJI,2,5,-3,245,500,-255,T,141
1928,Behind Coffins Playing the B Site Cross,SANJI,3,2,1,268,224,44,CT,141
1929,Behind Coffins Playing the B Site Cross,SANJI,0,0,0,0,0,0,T,141
1930,2nd Oranges,SANJI,0,1,-1,0,155,-155,CT,141
1931,2nd Oranges,SANJI,0,3,-3,0,278,-278,T,141
1932,B Site,SANJI,2,0,2,150,0,150,CT,141
1933,B Site,SANJI,3,1,2,208,132,76,T,141
1934,A Bombsite Close Left,SANJI,1,0,1,37,86,-49,CT,141
1935,A Bombsite Close Left,SANJI,1,0,1,170,0,170,T,141
1936,CT Peek Towards B Choke,SANJI,4,3,1,551,311,240,CT,141
1937,CT Peek Towards B Choke,SANJI,1,0,1,70,25,45,T,141
1938,Top Mid Arch Side,SANJI,3,1,2,321,154,167,CT,141
1939,Top Mid Arch Side,SANJI,0,0,0,0,0,0,T,141
1940,Outside Library,SANJI,0,1,-1,24,126,-102,CT,141
1941,Outside Library,SANJI,0,1,-1,0,100,-100,T,141
1942,Chokepoint Entrance onto A site from Library Side,SANJI,0,1,-1,136,100,36,CT,141
1943,Chokepoint Entrance onto A site from Library Side,SANJI,0,0,0,0,0,0,T,141
1944,CT Outside Construction,SANJI,1,3,-2,187,251,-64,CT,141
1945,CT Outside Construction,SANJI,1,1,0,132,100,32,T,141
1946,Top Mid Chokepoint,SANJI,1,0,1,101,0,101,CT,141
1947,Top Mid Chokepoint,SANJI,1,2,-1,100,155,-55,T,141
1948,Arch Side,SANJI,1,2,-1,368,282,86,CT,141
1949,Arch Side,SANJI,1,0,1,91,0,91,T,141
1950,A Site,SANJI,0,0,0,52,1,51,CT,141
1951,A Site,SANJI,0,1,-1,0,64,-64,T,141
1952,Chokepoint Entering B,SANJI,0,1,-1,171,144,27,CT,141
1953,Chokepoint Entering B,SANJI,3,1,2,385,238,147,T,141
1954,Deep CT Peeking Towards B Site,SANJI,1,3,-2,94,191,-97,CT,141
1955,Deep CT Peeking Towards B Site,SANJI,0,1,-1,0,97,-97,T,141
1956,Pit Peek Towards Lane,SANJI,0,0,0,0,0,0,CT,141
1957,Pit Peek Towards Lane,SANJI,3,1,2,210,100,110,T,141
1958,Front Coffins,SANJI,0,0,0,5,0,5,CT,141
1959,Front Coffins,SANJI,0,2,-2,0,132,-132,T,141
1960,Library,SANJI,0,2,-2,89,200,-111,CT,141
1961,Library,SANJI,0,0,0,0,0,0,T,141
1962,B Site Cross for T's Exposed to CT and Quad,SANJI,0,0,0,0,6,-6,CT,141
1963,B Site Cross for T's Exposed to CT and Quad,SANJI,0,2,-2,22,163,-141,T,141
1964,Banana,SANJI,0,0,0,0,19,-19,CT,141
1965,Banana,SANJI,0,2,-2,10,200,-190,T,141
1966,Back Alley,SANJI,0,0,0,0,0,0,CT,141
1967,Back Alley,SANJI,0,2,-2,62,216,-154,T,141
1968,Pit,SANJI,0,0,0,0,0,0,CT,141
1969,Pit,SANJI,1,0,1,134,47,87,T,141
1970,A Bombsite Back Site,SANJI,4,1,3,370,178,192,CT,141
1971,A Bombsite Back Site,SANJI,0,1,-1,0,76,-76,T,141
1972,SecondMid,SANJI,0,0,0,0,0,0,CT,141
1973,SecondMid,SANJI,1,1,0,100,104,-4,T,141
1974,A Site Right Side Middle Pillar,SANJI,0,2,-2,0,166,-166,CT,141
1975,A Site Right Side Middle Pillar,SANJI,0,0,0,0,0,0,T,141
1976,1st Oranges,SANJI,2,1,1,166,99,67,CT,141
1977,1st Oranges,SANJI,0,1,-1,22,122,-100,T,141
1978,Bottom Mid exposed to Top Mid,SANJI,0,0,0,0,0,0,CT,141
1979,Bottom Mid exposed to Top Mid,SANJI,1,1,0,100,169,-69,T,141
1980,A Site Behind Middle Boxes/Pillar hidden from Lane,SANJI,2,1,1,123,100,23,CT,141
1981,A Site Behind Middle Boxes/Pillar hidden from Lane,SANJI,0,0,0,0,0,0,T,141
1982,Deep Apps Past Hallway,SANJI,0,0,0,7,0,7,CT,141
1983,Deep Apps Past Hallway,SANJI,0,1,-1,30,100,-70,T,141
1984,Apps Hallway,SANJI,0,0,0,0,0,0,CT,141
1985,Apps Hallway,SANJI,1,1,0,122,166,-44,T,141
1986,Default Plant A Site,SANJI,0,0,0,0,0,0,CT,141
1987,Default Plant A Site,SANJI,0,0,0,0,0,0,T,141
1988,Boiler Peek to Mid,SANJI,0,0,0,0,0,0,CT,141
1989,Boiler Peek to Mid,SANJI,2,0,2,200,91,109,T,141
1990,Apartments,SANJI,0,0,0,0,0,0,CT,141
1991,Apartments,SANJI,2,1,1,77,126,-49,T,141
1992,CT Banana Half Wall Side,SANJI,0,0,0,10,0,10,CT,141
1993,CT Banana Half Wall Side,SANJI,0,2,-2,105,150,-45,T,141
1994,Lane Patio,SANJI,1,1,0,74,100,-26,CT,141
1995,Lane Patio,SANJI,0,0,0,0,2,-2,T,141
1996,Apartments Cubby,SANJI,0,0,0,0,0,0,CT,141
1997,Apartments Cubby,SANJI,0,0,0,0,0,0,T,141
1998,CT Banana Barrels,SANJI,0,0,0,0,0,0,CT,141
1999,CT Banana Barrels,SANJI,1,1,0,100,18,82,T,141
2000,Attic,SANJI,0,1,-1,0,23,-23,CT,141
2001,Attic,SANJI,0,0,0,0,0,0,T,141
2002,Quad Box,SANJI,0,0,0,197,0,197,CT,141
2003,Quad Box,SANJI,0,0,0,0,0,0,T,141
2004,A Site Left Side Middle Boxes,SANJI,1,1,0,78,100,-22,CT,141
2005,A Site Left Side Middle Boxes,SANJI,0,0,0,0,0,0,T,141
2006,Next to Library Cubby,SANJI,0,1,-1,0,19,-19,CT,141
2007,Next to Library Cubby,SANJI,0,0,0,0,0,0,T,141
2008,Top Coffins,SANJI,0,0,0,55,0,55,CT,141
2009,Top Coffins,SANJI,0,1,-1,0,37,-37,T,141
2010,CT Arch,SANJI,1,1,0,138,100,38,CT,141
2011,CT Arch,SANJI,0,0,0,0,2,-2,T,141
2012,Middle,SANJI,0,0,0,0,0,0,CT,141
2013,Middle,SANJI,0,0,0,0,39,-39,T,141
2014,Apps T Side Stairs,SANJI,0,0,0,40,0,40,CT,141
2015,Apps T Side Stairs,SANJI,1,0,1,100,37,63,T,141
2016,CT Boost,SANJI,0,0,0,91,0,91,CT,141
2017,CT Boost,SANJI,0,0,0,0,0,0,T,141
2018,CT Speed Way,SANJI,0,1,-1,0,41,-41,CT,141
2019,CT Speed Way,SANJI,0,0,0,0,0,0,T,141
2020,TopofMid,SANJI,0,1,-1,0,46,-46,CT,141
2021,TopofMid,SANJI,0,0,0,0,0,0,T,141
2022,CT Banana Sandbangs,SANJI,1,0,1,128,133,-5,CT,141
2023,CT Banana Sandbangs,SANJI,1,0,1,164,0,164,T,141
2024,Construction,SANJI,1,0,1,100,35,65,CT,141
2025,Construction,SANJI,0,0,0,0,0,0,T,141
2026,Bottom Graveyard,SANJI,0,0,0,0,0,0,CT,141
2027,Bottom Graveyard,SANJI,0,1,-1,0,58,-58,T,141
2028,Boiler Side Stairs,SANJI,1,0,1,115,0,115,CT,141
2029,Boiler Side Stairs,SANJI,2,0,2,200,0,200,T,141
2030,Apartments Hallway Peek from T Side,SANJI,0,0,0,0,0,0,CT,141
2031,Apartments Hallway Peek from T Side,SANJI,1,1,0,100,111,-11,T,141
2032,Dark,SANJI,0,0,0,27,27,0,CT,141
2033,Dark,SANJI,0,0,0,0,0,0,T,141
2034,Lane Side,interz,1,2,-1,125,206,-81,CT,160
2035,Lane Side,interz,5,5,0,592,489,103,T,160
2036,Top Balcony ,interz,0,0,0,0,0,0,CT,160
2037,Top Balcony ,interz,0,2,-2,0,215,-215,T,160
2038,Banana,interz,0,0,0,0,0,0,CT,160
2039,Banana,interz,2,6,-4,274,764,-490,T,160
2040,Chokepoint Entering B,interz,0,2,-2,278,337,-59,CT,160
2041,Chokepoint Entering B,interz,0,5,-5,80,399,-319,T,160
2042,Top Mid Lane Side ,interz,1,1,0,18,28,-10,CT,160
2043,Top Mid Lane Side ,interz,1,3,-2,144,386,-242,T,160
2044,A Bombsite Back Site,interz,11,6,5,1097,692,405,CT,160
2045,A Bombsite Back Site,interz,0,0,0,0,0,0,T,160
2046,CT Banana Half Wall Side,interz,0,0,0,26,0,26,CT,160
2047,CT Banana Half Wall Side,interz,0,7,-7,187,624,-437,T,160
2048,Top Mid Chokepoint,interz,0,1,-1,0,37,-37,CT,160
2049,Top Mid Chokepoint,interz,0,3,-3,38,372,-334,T,160
2050,A Bombsite Close Left,interz,1,1,0,177,153,24,CT,160
2051,A Bombsite Close Left,interz,2,0,2,164,0,164,T,160
2052,Top Mid Arch Side,interz,1,0,1,109,0,109,CT,160
2053,Top Mid Arch Side,interz,0,3,-3,125,315,-190,T,160
2054,Pit Below Balcony,interz,0,1,-1,70,100,-30,CT,160
2055,Pit Below Balcony,interz,0,1,-1,0,22,-22,T,160
2056,CT Peek Towards B Choke,interz,3,3,0,84,352,-268,CT,160
2057,CT Peek Towards B Choke,interz,0,2,-2,118,267,-149,T,160
2058,A Site,interz,2,2,0,187,243,-56,CT,160
2059,A Site,interz,0,1,-1,26,31,-5,T,160
2060,Pit Peek Towards Lane,interz,6,1,5,606,239,367,CT,160
2061,Pit Peek Towards Lane,interz,1,2,-1,47,115,-68,T,160
2062,Grill,interz,1,0,1,100,0,100,CT,160
2063,Grill,interz,0,1,-1,0,100,-100,T,160
2064,Behind Coffins Playing the B Site Cross,interz,3,3,0,284,273,11,CT,160
2065,Behind Coffins Playing the B Site Cross,interz,0,0,0,0,0,0,T,160
2066,Behind B Site Back Pillar,interz,0,0,0,0,0,0,CT,160
2067,Behind B Site Back Pillar,interz,0,0,0,0,0,0,T,160
2068,Default Plant A Site,interz,0,0,0,0,0,0,CT,160
2069,Default Plant A Site,interz,1,0,1,100,38,62,T,160
2070,B Site,interz,2,2,0,186,251,-65,CT,160
2071,B Site,interz,0,1,-1,0,100,-100,T,160
2072,A Site Behind Middle Boxes/Pillar hidden from Lane,interz,5,2,3,535,305,230,CT,160
2073,A Site Behind Middle Boxes/Pillar hidden from Lane,interz,0,0,0,0,0,0,T,160
2074,1st Oranges,interz,1,1,0,100,100,0,CT,160
2075,1st Oranges,interz,0,1,-1,0,100,-100,T,160
2076,Lane Behind Pillar,interz,2,2,0,213,254,-41,CT,160
2077,Lane Behind Pillar,interz,0,0,0,4,0,4,T,160
2078,CT Outside Construction,interz,1,1,0,182,42,140,CT,160
2079,CT Outside Construction,interz,0,0,0,0,0,0,T,160
2080,Top Hay Bales,interz,0,0,0,0,0,0,CT,160
2081,Top Hay Bales,interz,0,0,0,0,0,0,T,160
2082,Deep Apps Past Hallway,interz,0,1,-1,0,100,-100,CT,160
2083,Deep Apps Past Hallway,interz,0,1,-1,0,100,-100,T,160
2084,Left Side Quadbox Peek for a CT,interz,0,0,0,0,0,0,CT,160
2085,Left Side Quadbox Peek for a CT,interz,0,0,0,0,0,0,T,160
2086,Chokepoint Entrance onto A site from Library Side,interz,0,0,0,27,0,27,CT,160
2087,Chokepoint Entrance onto A site from Library Side,interz,0,0,0,0,69,-69,T,160
2088,Quad Box,interz,1,0,1,19,0,19,CT,160
2089,Quad Box,interz,0,0,0,0,0,0,T,160
2090,Middle,interz,0,0,0,0,0,0,CT,160
2091,Middle,interz,1,1,0,125,183,-58,T,160
2092,CT Speed Way,interz,0,1,-1,0,46,-46,CT,160
2093,CT Speed Way,interz,0,1,-1,0,79,-79,T,160
2094,Lane Patio,interz,2,1,1,354,100,254,CT,160
2095,Lane Patio,interz,0,0,0,10,16,-6,T,160
2096,CT Outside Kitchen,interz,0,0,0,0,0,0,CT,160
2097,CT Outside Kitchen,interz,1,0,1,61,0,61,T,160
2098,Boiler Peek to Mid,interz,0,0,0,0,0,0,CT,160
2099,Boiler Peek to Mid,interz,0,0,0,0,20,-20,T,160
2100,A Site Right Side Middle Pillar,interz,0,0,0,0,0,0,CT,160
2101,A Site Right Side Middle Pillar,interz,0,0,0,0,0,0,T,160
2102,B Site Cross for T's Exposed to CT and Quad,interz,0,0,0,16,0,16,CT,160
2103,B Site Cross for T's Exposed to CT and Quad,interz,1,0,1,100,0,100,T,160
2104,Top Graveyard,interz,0,0,0,0,0,0,CT,160
2105,Top Graveyard,interz,0,0,0,0,0,0,T,160
2106,Library,interz,0,0,0,0,0,0,CT,160
2107,Library,interz,0,0,0,0,0,0,T,160
2108,Pit,interz,2,0,2,152,0,152,CT,160
2109,Pit,interz,2,0,2,76,14,62,T,160
2110,CT Arch,interz,0,1,-1,27,100,-73,CT,160
2111,CT Arch,interz,0,0,0,0,0,0,T,160
2112,Front Coffins,interz,0,0,0,0,0,0,CT,160
2113,Front Coffins,interz,0,1,-1,0,9,-9,T,160
2114,Bottom Mid Banana,interz,0,0,0,0,0,0,CT,160
2115,Bottom Mid Banana,interz,1,1,0,158,125,33,T,160
2116,Graveyard Stairs,interz,1,1,0,100,100,0,CT,160
2117,Graveyard Stairs,interz,0,0,0,0,0,0,T,160
2118,2nd Oranges,interz,0,0,0,0,21,-21,CT,160
2119,2nd Oranges,interz,0,0,0,0,0,0,T,160
2120,CT Banana Sandbags Right Corner,interz,0,0,0,0,0,0,CT,160
2121,CT Banana Sandbags Right Corner,interz,0,0,0,0,0,0,T,160
2122,Bottom Mid exposed to Top Mid,interz,0,0,0,0,0,0,CT,160
2123,Bottom Mid exposed to Top Mid,interz,0,0,0,0,0,0,T,160
2124,Underpass,interz,0,0,0,0,0,0,CT,160
2125,Underpass,interz,1,1,0,100,55,45,T,160
2126,Boiler Side Stairs,interz,0,0,0,0,0,0,CT,160
2127,Boiler Side Stairs,interz,0,0,0,0,0,0,T,160
2128,A Site Behind Default Boxes,interz,1,0,1,138,22,116,CT,160
2129,A Site Behind Default Boxes,interz,0,0,0,0,0,0,T,160
2130,Back Alley,interz,0,0,0,0,0,0,CT,160
2131,Back Alley,interz,0,1,-1,0,17,-17,T,160
2132,CT Outside Arch,interz,0,0,0,0,0,0,CT,160
2133,CT Outside Arch,interz,0,1,-1,46,97,-51,T,160
2134,SecondMid,interz,0,0,0,0,0,0,CT,160
2135,SecondMid,interz,2,1,1,163,131,32,T,160
2136,Construction,interz,0,0,0,87,0,87,CT,160
2137,Construction,interz,0,0,0,0,0,0,T,160
2138,Arch Side,interz,0,0,0,6,0,6,CT,160
2139,Arch Side,interz,0,1,-1,0,121,-121,T,160
2140,Fountain,interz,0,1,-1,0,55,-55,CT,160
2141,Fountain,interz,0,0,0,0,0,0,T,160
2142,CT Banana Sandbangs,interz,0,1,-1,0,30,-30,CT,160
2143,CT Banana Sandbangs,interz,1,0,1,81,48,33,T,160
2144,T Ramp Peeking Towards Mid,interz,0,0,0,0,0,0,CT,160
2145,T Ramp Peeking Towards Mid,interz,1,1,0,127,100,27,T,160
2146,TRamp,interz,0,0,0,0,0,0,CT,160
2147,TRamp,interz,0,0,0,0,0,0,T,160
2148,Deep CT Peeking Towards B Site,interz,2,1,1,178,82,96,CT,160
2149,Deep CT Peeking Towards B Site,interz,1,0,1,100,0,100,T,160
2150,Apps T Side Stairs,interz,0,0,0,0,24,-24,CT,160
2151,Apps T Side Stairs,interz,0,0,0,0,0,0,T,160
2152,Chokepoint Entering B,device,2,3,-1,183,330,-147,CT,106
2153,Chokepoint Entering B,device,1,2,-1,194,174,20,T,106
2154,Lane Side,device,4,1,3,306,127,179,CT,106
2155,Lane Side,device,6,3,3,606,365,241,T,106
2156,Top Mid Lane Side ,device,4,4,0,386,397,-11,CT,106
2157,Top Mid Lane Side ,device,0,1,-1,76,100,-24,T,106
2158,Top Mid Chokepoint,device,0,0,0,0,0,0,CT,106
2159,Top Mid Chokepoint,device,0,0,0,0,0,0,T,106
2160,Banana,device,0,0,0,0,0,0,CT,106
2161,Banana,device,1,5,-4,150,731,-581,T,106
2162,Top Mid Arch Side,device,1,2,-1,252,200,52,CT,106
2163,Top Mid Arch Side,device,2,1,1,107,169,-62,T,106
2164,Left Side Quadbox Peek for a CT,device,1,1,0,92,97,-5,CT,106
2165,Left Side Quadbox Peek for a CT,device,2,2,0,174,54,120,T,106
2166,Top Balcony ,device,0,0,0,0,0,0,CT,106
2167,Top Balcony ,device,0,2,-2,14,206,-192,T,106
2168,CT Peek Towards B Choke,device,2,3,-1,196,308,-112,CT,106
2169,CT Peek Towards B Choke,device,0,0,0,0,21,-21,T,106
2170,Deep Apps Past Hallway,device,0,1,-1,0,100,-100,CT,106
2171,Deep Apps Past Hallway,device,0,1,-1,28,100,-72,T,106
2172,Deep CT Peeking Towards B Site,device,3,1,2,170,42,128,CT,106
2173,Deep CT Peeking Towards B Site,device,0,1,-1,0,100,-100,T,106
2174,T Ramp Peeking Towards Mid,device,0,1,-1,0,98,-98,CT,106
2175,T Ramp Peeking Towards Mid,device,0,1,-1,6,100,-94,T,106
2176,Chokepoint Entrance onto A site from Library Side,device,2,0,2,192,0,192,CT,106
2177,Chokepoint Entrance onto A site from Library Side,device,0,0,0,0,0,0,T,106
2178,B Site,device,0,1,-1,72,73,-1,CT,106
2179,B Site,device,0,0,0,0,0,0,T,106
2180,Bottom Mid exposed to Top Mid,device,0,0,0,0,0,0,CT,106
2181,Bottom Mid exposed to Top Mid,device,0,1,-1,14,100,-86,T,106
2182,A Bombsite Back Site,device,0,1,-1,0,2,-2,CT,106
2183,A Bombsite Back Site,device,1,1,0,124,36,88,T,106
2184,Arch Side,device,5,3,2,464,343,121,CT,106
2185,Arch Side,device,0,0,0,0,0,0,T,106
2186,CT Banana Half Wall Side,device,1,1,0,94,76,18,CT,106
2187,CT Banana Half Wall Side,device,2,1,1,175,122,53,T,106
2188,Middle,device,0,0,0,0,0,0,CT,106
2189,Middle,device,2,1,1,224,100,124,T,106
2190,Right Side Quadbox Peek for a CT,device,1,1,0,44,38,6,CT,106
2191,Right Side Quadbox Peek for a CT,device,0,1,-1,27,100,-73,T,106
2192,Dark,device,0,0,0,0,0,0,CT,106
2193,Dark,device,1,0,1,22,32,-10,T,106
2194,CT Boost,device,0,0,0,0,25,-25,CT,106
2195,CT Boost,device,0,0,0,0,0,0,T,106
2196,Library,device,0,0,0,0,0,0,CT,106
2197,Library,device,0,0,0,0,0,0,T,106
2198,Top Coffins,device,1,0,1,59,0,59,CT,106
2199,Top Coffins,device,0,0,0,0,0,0,T,106
2200,CT Banana Sandbangs,device,2,0,2,98,8,90,CT,106
2201,CT Banana Sandbangs,device,1,0,1,116,19,97,T,106
2202,B Site Cross for T's Exposed to CT and Quad,device,0,0,0,0,28,-28,CT,106
2203,B Site Cross for T's Exposed to CT and Quad,device,2,0,2,115,0,115,T,106
2204,Apps T Side Stairs,device,1,0,1,100,0,100,CT,106
2205,Apps T Side Stairs,device,0,1,-1,0,100,-100,T,106
2206,Top Hay Bales,device,0,0,0,0,0,0,CT,106
2207,Top Hay Bales,device,0,1,-1,0,70,-70,T,106
2208,CT Banana Barrels,device,2,0,2,200,62,138,CT,106
2209,CT Banana Barrels,device,1,2,-1,68,152,-84,T,106
2210,A Site Behind Default Boxes,device,1,2,-1,20,200,-180,CT,106
2211,A Site Behind Default Boxes,device,0,0,0,0,0,0,T,106
2212,Pit,device,2,1,1,189,100,89,CT,106
2213,Pit,device,0,0,0,0,0,0,T,106
2214,Pit Peek Towards Lane,device,3,0,3,241,0,241,CT,106
2215,Pit Peek Towards Lane,device,0,0,0,0,0,0,T,106
2216,Grill,device,0,0,0,0,0,0,CT,106
2217,Grill,device,1,0,1,100,0,100,T,106
2218,Lane Patio,device,0,0,0,0,0,0,CT,106
2219,Lane Patio,device,0,1,-1,0,44,-44,T,106
2220,A Site Behind Middle Boxes/Pillar hidden from Lane,device,0,1,-1,0,62,-62,CT,106
2221,A Site Behind Middle Boxes/Pillar hidden from Lane,device,0,0,0,0,0,0,T,106
2222,Next to Library Cubby,device,1,1,0,56,74,-18,CT,106
2223,Next to Library Cubby,device,0,0,0,0,0,0,T,106
2224,CT Tree,device,0,0,0,0,0,0,CT,106
2225,CT Tree,device,0,0,0,0,0,0,T,106
2226,Lane Peek Towards Top Mid,device,0,1,-1,40,100,-60,CT,106
2227,Lane Peek Towards Top Mid,device,0,0,0,0,0,0,T,106
2228,Underpass,device,0,0,0,0,0,0,CT,106
2229,Underpass,device,0,1,-1,0,100,-100,T,106
2230,CT Banana Sandbags Right Corner,device,0,0,0,0,0,0,CT,106
2231,CT Banana Sandbags Right Corner,device,1,0,1,126,39,87,T,106
2232,Bottom Mid Banana,device,0,0,0,0,0,0,CT,106
2233,Bottom Mid Banana,device,0,0,0,81,0,81,T,106
2234,Behind Coffins Playing the B Site Cross,device,1,0,1,50,0,50,CT,106
2235,Behind Coffins Playing the B Site Cross,device,0,0,0,8,8,0,T,106
2236,Pit Below Balcony,device,0,0,0,0,0,0,CT,106
2237,Pit Below Balcony,device,2,1,1,139,72,67,T,106
2238,Apps Hallway,device,0,1,-1,0,100,-100,CT,106
2239,Apps Hallway,device,0,0,0,0,0,0,T,106
2240,Fountain,device,0,0,0,0,0,0,CT,106
2241,Fountain,device,0,0,0,0,0,0,T,106
2242,A Bombsite Close Left,device,0,0,0,0,0,0,CT,106
2243,A Bombsite Close Left,device,0,0,0,0,18,-18,T,106
2244,Construction,device,0,1,-1,0,40,-40,CT,106
2245,Construction,device,1,0,1,95,54,41,T,106
2246,Boiler Peek to Mid,device,0,0,0,0,0,0,CT,106
2247,Boiler Peek to Mid,device,0,0,0,0,0,0,T,106
2248,Boiler Room,device,0,1,-1,0,100,-100,CT,106
2249,Boiler Room,device,0,0,0,0,0,0,T,106
2250,Front Coffins,device,0,0,0,0,0,0,CT,106
2251,Front Coffins,device,0,0,0,0,0,0,T,106
2252,Logs,device,0,0,0,0,0,0,CT,106
2253,Logs,device,0,0,0,0,18,-18,T,106
2254,Apartments,device,0,1,-1,0,108,-108,CT,106
2255,Apartments,device,0,0,0,0,0,0,T,106
2256,A Site,device,1,0,1,107,0,107,CT,106
2257,A Site,device,0,1,-1,0,81,-81,T,106
2258,Banana,tarik,3,5,-2,247,351,-104,CT,138
2259,Banana,tarik,2,5,-3,238,526,-288,T,138
2260,Top Mid Arch Side,tarik,2,1,1,125,177,-52,CT,138
2261,Top Mid Arch Side,tarik,1,5,-4,159,405,-246,T,138
2262,Arch Side,tarik,1,0,1,49,1,48,CT,138
2263,Arch Side,tarik,1,2,-1,100,179,-79,T,138
2264,Chokepoint Entering B,tarik,2,0,2,211,142,69,CT,138
2265,Chokepoint Entering B,tarik,1,1,0,100,27,73,T,138
2266,Lane Side,tarik,0,1,-1,0,17,-17,CT,138
2267,Lane Side,tarik,1,2,-1,114,229,-115,T,138
2268,CT Peek Towards B Choke,tarik,3,1,2,339,102,237,CT,138
2269,CT Peek Towards B Choke,tarik,1,3,-2,290,205,85,T,138
2270,CT Banana Half Wall Side,tarik,3,2,1,645,711,-66,CT,138
2271,CT Banana Half Wall Side,tarik,0,0,0,0,5,-5,T,138
2272,B Site Cross for T's Exposed to CT and Quad,tarik,0,0,0,43,0,43,CT,138
2273,B Site Cross for T's Exposed to CT and Quad,tarik,2,3,-1,264,300,-36,T,138
2274,Middle,tarik,1,2,-1,102,292,-190,CT,138
2275,Middle,tarik,1,1,0,100,106,-6,T,138
2276,A Bombsite Close Left,tarik,0,0,0,0,0,0,CT,138
2277,A Bombsite Close Left,tarik,0,2,-2,0,139,-139,T,138
2278,Behind Coffins Playing the B Site Cross,tarik,2,3,-1,200,253,-53,CT,138
2279,Behind Coffins Playing the B Site Cross,tarik,0,0,0,0,41,-41,T,138
2280,Apps T Side Stairs,tarik,0,0,0,0,0,0,CT,138
2281,Apps T Side Stairs,tarik,0,2,-2,116,224,-108,T,138
2282,Pit Below Balcony,tarik,0,0,0,0,0,0,CT,138
2283,Pit Below Balcony,tarik,1,3,-2,100,275,-175,T,138
2284,Top Balcony ,tarik,0,0,0,0,0,0,CT,138
2285,Top Balcony ,tarik,0,4,-4,116,397,-281,T,138
2286,Top Mid Chokepoint,tarik,0,0,0,0,0,0,CT,138
2287,Top Mid Chokepoint,tarik,1,3,-2,180,398,-218,T,138
2288,Library,tarik,1,1,0,156,123,33,CT,138
2289,Library,tarik,0,0,0,0,0,0,T,138
2290,Bottom Mid exposed to Top Mid,tarik,0,1,-1,0,100,-100,CT,138
2291,Bottom Mid exposed to Top Mid,tarik,1,1,0,130,120,10,T,138
2292,Dark,tarik,2,2,0,135,172,-37,CT,138
2293,Dark,tarik,0,0,0,0,19,-19,T,138
2294,Default Plant A Site,tarik,0,1,-1,0,12,-12,CT,138
2295,Default Plant A Site,tarik,0,1,-1,99,84,15,T,138
2296,2nd Oranges,tarik,0,0,0,0,0,0,CT,138
2297,2nd Oranges,tarik,1,2,-1,62,197,-135,T,138
2298,Chokepoint Entrance onto A site from Library Side,tarik,3,1,2,234,126,108,CT,138
2299,Chokepoint Entrance onto A site from Library Side,tarik,0,1,-1,0,5,-5,T,138
2300,Pit Peek Towards Lane,tarik,0,0,0,0,0,0,CT,138
2301,Pit Peek Towards Lane,tarik,2,0,2,192,45,147,T,138
2302,T Ramp Peeking Towards Mid,tarik,0,0,0,0,0,0,CT,138
2303,T Ramp Peeking Towards Mid,tarik,0,0,0,0,20,-20,T,138
2304,CT Banana Sandbangs,tarik,1,2,-1,197,202,-5,CT,138
2305,CT Banana Sandbangs,tarik,0,0,0,0,0,0,T,138
2306,B Site,tarik,1,0,1,45,30,15,CT,138
2307,B Site,tarik,0,1,-1,0,75,-75,T,138
2308,Underpass,tarik,0,0,0,0,0,0,CT,138
2309,Underpass,tarik,0,0,0,0,0,0,T,138
2310,1st Oranges,tarik,0,1,-1,0,100,-100,CT,138
2311,1st Oranges,tarik,0,1,-1,0,172,-172,T,138
2312,Apartments,tarik,0,0,0,0,0,0,CT,138
2313,Apartments,tarik,2,1,1,197,104,93,T,138
2314,SecondMid,tarik,0,0,0,0,0,0,CT,138
2315,SecondMid,tarik,2,0,2,221,89,132,T,138
2316,Top Mid Lane Side ,tarik,1,0,1,100,0,100,CT,138
2317,Top Mid Lane Side ,tarik,2,0,2,200,0,200,T,138
2318,Top Coffins,tarik,0,2,-2,0,116,-116,CT,138
2319,Top Coffins,tarik,0,0,0,35,0,35,T,138
2320,Right Side Quadbox Peek for a CT,tarik,0,0,0,0,0,0,CT,138
2321,Right Side Quadbox Peek for a CT,tarik,0,0,0,54,0,54,T,138
2322,Bottom Mid Banana,tarik,1,1,0,190,98,92,CT,138
2323,Bottom Mid Banana,tarik,0,0,0,0,0,0,T,138
2324,Grill,tarik,1,1,0,99,100,-1,CT,138
2325,Grill,tarik,0,0,0,0,104,-104,T,138
2326,CT Outside Kitchen,tarik,0,0,0,0,0,0,CT,138
2327,CT Outside Kitchen,tarik,0,0,0,0,0,0,T,138
2328,Construction Sandbags,tarik,0,1,-1,0,15,-15,CT,138
2329,Construction Sandbags,tarik,0,0,0,0,0,0,T,138
2330,Lane Peek Towards Top Mid,tarik,0,0,0,0,0,0,CT,138
2331,Lane Peek Towards Top Mid,tarik,0,0,0,0,0,0,T,138
2332,A Site Left Side Middle Boxes,tarik,0,0,0,0,0,0,CT,138
2333,A Site Left Side Middle Boxes,tarik,0,0,0,0,0,0,T,138
2334,Logs,tarik,0,0,0,0,0,0,CT,138
2335,Logs,tarik,2,0,2,191,202,-11,T,138
2336,CT Arch,tarik,0,0,0,0,0,0,CT,138
2337,CT Arch,tarik,0,0,0,9,0,9,T,138
2338,Front Coffins,tarik,0,0,0,0,3,-3,CT,138
2339,Front Coffins,tarik,0,1,-1,0,48,-48,T,138
2340,Lane Patio,tarik,0,0,0,0,0,0,CT,138
2341,Lane Patio,tarik,0,0,0,0,0,0,T,138
2342,Back Alley,tarik,0,0,0,0,0,0,CT,138
2343,Back Alley,tarik,0,0,0,0,0,0,T,138
2344,Graveyard Stairs,tarik,0,0,0,0,0,0,CT,138
2345,Graveyard Stairs,tarik,0,0,0,0,0,0,T,138
2346,Boiler Side Stairs,tarik,0,0,0,0,0,0,CT,138
2347,Boiler Side Stairs,tarik,0,1,-1,22,196,-174,T,138
2348,A Bombsite Back Site,tarik,0,0,0,0,0,0,CT,138
2349,A Bombsite Back Site,tarik,0,0,0,0,0,0,T,138
2350,Left Side Quadbox Peek for a CT,tarik,2,0,2,184,0,184,CT,138
2351,Left Side Quadbox Peek for a CT,tarik,0,1,-1,26,40,-14,T,138
2352,A Site Behind Middle Boxes/Pillar hidden from Lane,tarik,1,1,0,28,73,-45,CT,138
2353,A Site Behind Middle Boxes/Pillar hidden from Lane,tarik,0,0,0,0,0,0,T,138
2354,CT Banana Sandbags Right Corner,tarik,2,0,2,132,48,84,CT,138
2355,CT Banana Sandbags Right Corner,tarik,0,1,-1,35,97,-62,T,138
2356,Fountain,tarik,0,0,0,1,0,1,CT,138
2357,Fountain,tarik,0,1,-1,0,52,-52,T,138
2358,Boiler Room,tarik,1,1,0,100,100,0,CT,138
2359,Boiler Room,tarik,1,0,1,100,0,100,T,138
2360,Apartments Hallway Peek from T Side,tarik,0,0,0,0,0,0,CT,138
2361,Apartments Hallway Peek from T Side,tarik,0,1,-1,0,100,-100,T,138
2362,A Site Behind Default Boxes,tarik,0,0,0,0,0,0,CT,138
2363,A Site Behind Default Boxes,tarik,0,0,0,0,0,0,T,138
2364,CT Boost,tarik,0,1,-1,24,51,-27,CT,138
2365,CT Boost,tarik,0,0,0,0,0,0,T,138
2366,CT Outside Arch,tarik,4,0,4,369,0,369,CT,138
2367,CT Outside Arch,tarik,1,1,0,73,100,-27,T,138
2368,Top Hay Bales,tarik,0,0,0,0,0,0,CT,138
2369,Top Hay Bales,tarik,0,1,-1,0,100,-100,T,138
2370,Construction,tarik,1,0,1,67,0,67,CT,138
2371,Construction,tarik,1,0,1,58,0,58,T,138
2372,CT Spawn ,tarik,0,0,0,0,0,0,CT,138
2373,CT Spawn ,tarik,0,0,0,0,0,0,T,138
2374,Deep Apps Past Hallway,tarik,0,0,0,0,0,0,CT,138
2375,Deep Apps Past Hallway,tarik,0,0,0,8,36,-28,T,138
2376,Apps Hallway,tarik,0,0,0,0,0,0,CT,138
2377,Apps Hallway,tarik,1,0,1,126,41,85,T,138
2378,CT Outside Construction,tarik,0,0,0,0,15,-15,CT,138
2379,CT Outside Construction,tarik,1,0,1,100,54,46,T,138
2380,A Site,tarik,0,0,0,0,0,0,CT,138
2381,A Site,tarik,1,0,1,68,0,68,T,138
2382,CT Banana Half Wall Side,stanislaw,1,3,-2,182,310,-128,CT,138
2383,CT Banana Half Wall Side,stanislaw,4,6,-2,279,535,-256,T,138
2384,B Site,stanislaw,2,3,-1,304,380,-76,CT,138
2385,B Site,stanislaw,3,1,2,289,159,130,T,138
2386,Banana,stanislaw,2,0,2,182,92,90,CT,138
2387,Banana,stanislaw,5,7,-2,615,1088,-473,T,138
2388,Lane Side,stanislaw,1,2,-1,73,200,-127,CT,138
2389,Lane Side,stanislaw,6,7,-1,729,664,65,T,138
2390,B Site Cross for T's Exposed to CT and Quad,stanislaw,3,3,0,278,321,-43,CT,138
2391,B Site Cross for T's Exposed to CT and Quad,stanislaw,0,1,-1,0,104,-104,T,138
2392,Chokepoint Entering B,stanislaw,4,1,3,472,197,275,CT,138
2393,Chokepoint Entering B,stanislaw,3,1,2,258,200,58,T,138
2394,Chokepoint Entrance onto A site from Library Side,stanislaw,0,3,-3,50,300,-250,CT,138
2395,Chokepoint Entrance onto A site from Library Side,stanislaw,0,1,-1,0,100,-100,T,138
2396,CT Peek Towards B Choke,stanislaw,1,1,0,104,244,-140,CT,138
2397,CT Peek Towards B Choke,stanislaw,1,1,0,132,100,32,T,138
2398,Logs,stanislaw,4,0,4,356,47,309,CT,138
2399,Logs,stanislaw,1,0,1,34,95,-61,T,138
2400,Top Mid Chokepoint,stanislaw,0,0,0,11,63,-52,CT,138
2401,Top Mid Chokepoint,stanislaw,1,3,-2,88,262,-174,T,138
2402,A Bombsite Close Left,stanislaw,0,2,-2,0,88,-88,CT,138
2403,A Bombsite Close Left,stanislaw,0,0,0,49,0,49,T,138
2404,1st Oranges,stanislaw,1,2,-1,152,134,18,CT,138
2405,1st Oranges,stanislaw,0,0,0,32,0,32,T,138
2406,Pit Below Balcony,stanislaw,1,1,0,143,100,43,CT,138
2407,Pit Below Balcony,stanislaw,0,1,-1,0,31,-31,T,138
2408,CT Banana Sandbangs,stanislaw,1,1,0,233,109,124,CT,138
2409,CT Banana Sandbangs,stanislaw,0,0,0,3,0,3,T,138
2410,Middle,stanislaw,0,1,-1,0,100,-100,CT,138
2411,Middle,stanislaw,0,1,-1,32,25,7,T,138
2412,Top Mid Lane Side ,stanislaw,1,0,1,53,60,-7,CT,138
2413,Top Mid Lane Side ,stanislaw,0,1,-1,52,132,-80,T,138
2414,Top Balcony ,stanislaw,1,1,0,97,11,86,CT,138
2415,Top Balcony ,stanislaw,3,1,2,251,166,85,T,138
2416,Outside Library,stanislaw,0,0,0,1,0,1,CT,138
2417,Outside Library,stanislaw,0,3,-3,26,290,-264,T,138
2418,Behind B Site Back Pillar,stanislaw,0,0,0,0,0,0,CT,138
2419,Behind B Site Back Pillar,stanislaw,1,1,0,94,47,47,T,138
2420,Top Mid Arch Side,stanislaw,0,0,0,0,0,0,CT,138
2421,Top Mid Arch Side,stanislaw,0,1,-1,0,88,-88,T,138
2422,Pit Peek Towards Lane,stanislaw,0,0,0,0,0,0,CT,138
2423,Pit Peek Towards Lane,stanislaw,0,0,0,0,0,0,T,138
2424,Pit,stanislaw,0,0,0,0,0,0,CT,138
2425,Pit,stanislaw,0,0,0,0,0,0,T,138
2426,Bottom Mid Banana,stanislaw,0,0,0,0,0,0,CT,138
2427,Bottom Mid Banana,stanislaw,0,1,-1,57,113,-56,T,138
2428,Deep CT Peeking Towards B Site,stanislaw,1,0,1,123,0,123,CT,138
2429,Deep CT Peeking Towards B Site,stanislaw,0,0,0,0,0,0,T,138
2430,CT Boost,stanislaw,0,1,-1,0,41,-41,CT,138
2431,CT Boost,stanislaw,0,0,0,0,0,0,T,138
2432,CT Banana Barrels,stanislaw,0,1,-1,11,96,-85,CT,138
2433,CT Banana Barrels,stanislaw,0,0,0,0,0,0,T,138
2434,T Ramp Peeking Towards Mid,stanislaw,1,0,1,66,0,66,CT,138
2435,T Ramp Peeking Towards Mid,stanislaw,1,0,1,176,185,-9,T,138
2436,Arch Side,stanislaw,1,2,-1,80,195,-115,CT,138
2437,Arch Side,stanislaw,1,0,1,100,16,84,T,138
2438,A Site,stanislaw,0,0,0,0,0,0,CT,138
2439,A Site,stanislaw,0,1,-1,44,97,-53,T,138
2440,A Site Behind Default Boxes,stanislaw,1,0,1,13,0,13,CT,138
2441,A Site Behind Default Boxes,stanislaw,0,1,-1,24,81,-57,T,138
2442,Left Side Quadbox Peek for a CT,stanislaw,1,0,1,6,0,6,CT,138
2443,Left Side Quadbox Peek for a CT,stanislaw,1,0,1,100,86,14,T,138
2444,Behind Coffins Playing the B Site Cross,stanislaw,2,1,1,140,60,80,CT,138
2445,Behind Coffins Playing the B Site Cross,stanislaw,0,1,-1,0,37,-37,T,138
2446,Quad Box,stanislaw,0,0,0,0,0,0,CT,138
2447,Quad Box,stanislaw,1,1,0,78,146,-68,T,138
2448,Top Coffins,stanislaw,0,0,0,0,0,0,CT,138
2449,Top Coffins,stanislaw,0,1,-1,0,17,-17,T,138
2450,Library,stanislaw,0,1,-1,0,91,-91,CT,138
2451,Library,stanislaw,0,0,0,0,0,0,T,138
2452,Lane Peek Towards Top Mid,stanislaw,0,0,0,0,0,0,CT,138
2453,Lane Peek Towards Top Mid,stanislaw,1,0,1,112,27,85,T,138
2454,Default Plant A Site,stanislaw,0,0,0,33,0,33,CT,138
2455,Default Plant A Site,stanislaw,0,1,-1,0,100,-100,T,138
2456,Lane Patio,stanislaw,0,1,-1,88,100,-12,CT,138
2457,Lane Patio,stanislaw,0,0,0,0,0,0,T,138
2458,Grill,stanislaw,1,0,1,100,0,100,CT,138
2459,Grill,stanislaw,2,0,2,140,0,140,T,138
2460,2nd Oranges,stanislaw,0,0,0,20,0,20,CT,138
2461,2nd Oranges,stanislaw,0,0,0,38,100,-62,T,138
2462,Dark,stanislaw,0,1,-1,0,100,-100,CT,138
2463,Dark,stanislaw,0,0,0,0,0,0,T,138
2464,A Site Behind Middle Boxes/Pillar hidden from Lane,stanislaw,0,0,0,0,0,0,CT,138
2465,A Site Behind Middle Boxes/Pillar hidden from Lane,stanislaw,0,0,0,0,0,0,T,138
2466,CT Near Well,stanislaw,0,0,0,0,0,0,CT,138
2467,CT Near Well,stanislaw,0,0,0,0,0,0,T,138
2468,A Bombsite Back Site,stanislaw,0,0,0,0,0,0,CT,138
2469,A Bombsite Back Site,stanislaw,0,0,0,12,0,12,T,138
2470,Apps Hallway,stanislaw,0,0,0,0,0,0,CT,138
2471,Apps Hallway,stanislaw,0,0,0,0,0,0,T,138
2472,CT Outside Arch,stanislaw,0,1,-1,38,99,-61,CT,138
2473,CT Outside Arch,stanislaw,0,0,0,0,0,0,T,138
2474,CT Arch,stanislaw,0,0,0,0,1,-1,CT,138
2475,CT Arch,stanislaw,0,0,0,0,0,0,T,138
2476,Fountain,stanislaw,0,0,0,0,0,0,CT,138
2477,Fountain,stanislaw,0,1,-1,0,6,-6,T,138
2478,Boiler Room,stanislaw,0,0,0,0,0,0,CT,138
2479,Boiler Room,stanislaw,1,1,0,141,127,14,T,138
2480,SecondMid,stanislaw,0,0,0,0,0,0,CT,138
2481,SecondMid,stanislaw,0,1,-1,0,76,-76,T,138
2482,Bottom Mid exposed to Top Mid,stanislaw,0,0,0,0,0,0,CT,138
2483,Bottom Mid exposed to Top Mid,stanislaw,0,0,0,0,0,0,T,138
2484,Apartments,stanislaw,0,0,0,0,0,0,CT,138
2485,Apartments,stanislaw,0,0,0,0,0,0,T,138
2486,CT Outside Construction,stanislaw,0,0,0,90,27,63,CT,138
2487,CT Outside Construction,stanislaw,0,1,-1,63,100,-37,T,138
2488,Front Coffins,stanislaw,0,0,0,0,0,0,CT,138
2489,Front Coffins,stanislaw,2,1,1,187,96,91,T,138
2490,A Site Right Side Middle Pillar,stanislaw,0,0,0,0,0,0,CT,138
2491,A Site Right Side Middle Pillar,stanislaw,0,1,-1,0,0,0,T,138
2492,LowerMid,stanislaw,0,0,0,0,0,0,CT,138
2493,LowerMid,stanislaw,0,1,-1,0,100,-100,T,138
2494,Chokepoint Entering B,robiin,2,1,1,395,294,101,CT,133
2495,Chokepoint Entering B,robiin,1,5,-4,256,815,-559,T,133
2496,CT Banana Half Wall Side,robiin,4,3,1,466,378,88,CT,133
2497,CT Banana Half Wall Side,robiin,2,1,1,173,95,78,T,133
2498,Arch Side,robiin,0,3,-3,79,300,-221,CT,133
2499,Arch Side,robiin,0,2,-2,133,191,-58,T,133
2500,B Site Cross for T's Exposed to CT and Quad,robiin,2,3,-1,499,291,208,CT,133
2501,B Site Cross for T's Exposed to CT and Quad,robiin,1,2,-1,71,218,-147,T,133
2502,Banana,robiin,0,2,-2,68,215,-147,CT,133
2503,Banana,robiin,0,0,0,7,27,-20,T,133
2504,B Site,robiin,3,3,0,239,262,-23,CT,133
2505,B Site,robiin,1,4,-3,158,310,-152,T,133
2506,CT Banana Sandbangs,robiin,2,4,-2,421,444,-23,CT,133
2507,CT Banana Sandbangs,robiin,2,1,1,324,80,244,T,133
2508,Top Mid Chokepoint,robiin,0,1,-1,22,100,-78,CT,133
2509,Top Mid Chokepoint,robiin,2,3,-1,199,360,-161,T,133
2510,T Ramp Peeking Towards Mid,robiin,0,0,0,0,0,0,CT,133
2511,T Ramp Peeking Towards Mid,robiin,2,2,0,222,200,22,T,133
2512,Behind Coffins Playing the B Site Cross,robiin,0,0,0,22,0,22,CT,133
2513,Behind Coffins Playing the B Site Cross,robiin,0,1,-1,0,100,-100,T,133
2514,Boiler Peek to Mid,robiin,0,0,0,0,0,0,CT,133
2515,Boiler Peek to Mid,robiin,0,2,-2,87,245,-158,T,133
2516,Top Mid Lane Side ,robiin,2,2,0,227,233,-6,CT,133
2517,Top Mid Lane Side ,robiin,2,1,1,164,210,-46,T,133
2518,Middle,robiin,3,1,2,119,100,19,CT,133
2519,Middle,robiin,0,0,0,0,1,-1,T,133
2520,Top Mid Arch Side,robiin,1,1,0,90,44,46,CT,133
2521,Top Mid Arch Side,robiin,1,3,-2,170,129,41,T,133
2522,Lane Side,robiin,0,1,-1,15,100,-85,CT,133
2523,Lane Side,robiin,5,2,3,396,245,151,T,133
2524,1st Oranges,robiin,2,2,0,152,200,-48,CT,133
2525,1st Oranges,robiin,0,1,-1,88,44,44,T,133
2526,CT Boost,robiin,0,1,-1,0,48,-48,CT,133
2527,CT Boost,robiin,0,0,0,0,0,0,T,133
2528,CT Banana Sandbags Right Corner,robiin,0,1,-1,26,85,-59,CT,133
2529,CT Banana Sandbags Right Corner,robiin,1,2,-1,61,227,-166,T,133
2530,A Bombsite Close Left,robiin,3,1,2,225,153,72,CT,133
2531,A Bombsite Close Left,robiin,1,1,0,100,78,22,T,133
2532,Grill,robiin,0,0,0,0,0,0,CT,133
2533,Grill,robiin,2,1,1,131,97,34,T,133
2534,CT Peek Towards B Choke,robiin,2,0,2,227,53,174,CT,133
2535,CT Peek Towards B Choke,robiin,0,1,-1,0,99,-99,T,133
2536,Construction,robiin,1,1,0,127,71,56,CT,133
2537,Construction,robiin,0,0,0,0,0,0,T,133
2538,Outside Library,robiin,0,2,-2,131,164,-33,CT,133
2539,Outside Library,robiin,0,0,0,0,0,0,T,133
2540,Library,robiin,0,1,-1,0,136,-136,CT,133
2541,Library,robiin,0,0,0,0,0,0,T,133
2542,Default Plant A Site,robiin,0,0,0,0,0,0,CT,133
2543,Default Plant A Site,robiin,0,1,-1,36,100,-64,T,133
2544,Chokepoint Entrance onto A site from Library Side,robiin,0,1,-1,0,99,-99,CT,133
2545,Chokepoint Entrance onto A site from Library Side,robiin,0,1,-1,0,114,-114,T,133
2546,Pit,robiin,0,1,-1,0,100,-100,CT,133
2547,Pit,robiin,0,0,0,0,0,0,T,133
2548,A Site Behind Default Boxes,robiin,0,1,-1,0,11,-11,CT,133
2549,A Site Behind Default Boxes,robiin,0,0,0,0,0,0,T,133
2550,Lane Patio,robiin,0,1,-1,0,99,-99,CT,133
2551,Lane Patio,robiin,0,0,0,0,7,-7,T,133
2552,Logs,robiin,0,0,0,8,14,-6,CT,133
2553,Logs,robiin,0,0,0,0,2,-2,T,133
2554,CT Arch,robiin,0,0,0,0,0,0,CT,133
2555,CT Arch,robiin,0,1,-1,0,100,-100,T,133
2556,Bottom Mid exposed to Top Mid,robiin,1,1,0,67,142,-75,CT,133
2557,Bottom Mid exposed to Top Mid,robiin,0,0,0,0,0,0,T,133
2558,2nd Oranges,robiin,0,1,-1,0,93,-93,CT,133
2559,2nd Oranges,robiin,0,1,-1,0,100,-100,T,133
2560,A Bombsite Back Site,robiin,0,0,0,0,0,0,CT,133
2561,A Bombsite Back Site,robiin,0,0,0,0,0,0,T,133
2562,Next to Library Cubby,robiin,0,0,0,0,0,0,CT,133
2563,Next to Library Cubby,robiin,0,0,0,0,0,0,T,133
2564,Underpass,robiin,0,0,0,0,0,0,CT,133
2565,Underpass,robiin,0,0,0,0,10,-10,T,133
2566,Pit Peek Towards Lane,robiin,0,0,0,0,0,0,CT,133
2567,Pit Peek Towards Lane,robiin,2,0,2,156,0,156,T,133
2568,A Site Left Side Middle Boxes,robiin,0,0,0,43,0,43,CT,133
2569,A Site Left Side Middle Boxes,robiin,0,0,0,0,0,0,T,133
2570,Front Coffins,robiin,0,0,0,54,0,54,CT,133
2571,Front Coffins,robiin,1,1,0,66,80,-14,T,133
2572,Deep Apps Past Hallway,robiin,0,0,0,44,22,22,CT,133
2573,Deep Apps Past Hallway,robiin,2,0,2,200,0,200,T,133
2574,Top Graveyard,robiin,0,0,0,0,0,0,CT,133
2575,Top Graveyard,robiin,1,1,0,100,100,0,T,133
2576,Boiler Side Stairs,robiin,0,0,0,0,0,0,CT,133
2577,Boiler Side Stairs,robiin,0,0,0,0,5,-5,T,133
2578,Lane Behind Pillar,robiin,0,0,0,0,0,0,CT,133
2579,Lane Behind Pillar,robiin,0,0,0,0,0,0,T,133
2580,T Apps Bridge ,robiin,0,0,0,0,0,0,CT,133
2581,T Apps Bridge ,robiin,0,1,-1,23,128,-105,T,133
2582,Pit Below Balcony,robiin,0,0,0,0,0,0,CT,133
2583,Pit Below Balcony,robiin,0,0,0,0,0,0,T,133
2584,CT Spawn ,robiin,2,1,1,201,100,101,CT,133
2585,CT Spawn ,robiin,0,0,0,0,0,0,T,133
2586,CT Outside Arch,robiin,0,0,0,0,0,0,CT,133
2587,CT Outside Arch,robiin,0,1,-1,0,100,-100,T,133
2588,Arch Side Cubby,robiin,0,0,0,0,0,0,CT,133
2589,Arch Side Cubby,robiin,1,1,0,29,100,-71,T,133
2590,Behind B Site Back Pillar,robiin,1,1,0,113,105,8,CT,133
2591,Behind B Site Back Pillar,robiin,0,0,0,0,0,0,T,133
2592,Right Side Quadbox Peek for a CT,robiin,0,0,0,0,0,0,CT,133
2593,Right Side Quadbox Peek for a CT,robiin,0,0,0,0,0,0,T,133
2594,Top Balcony ,robiin,1,0,1,97,0,97,CT,133
2595,Top Balcony ,robiin,0,0,0,0,0,0,T,133
2596,A Site,robiin,1,0,1,57,0,57,CT,133
2597,A Site,robiin,0,1,-1,0,86,-86,T,133
2598,A Bombsite Close Left,ztr,5,3,2,497,263,234,CT,153
2599,A Bombsite Close Left,ztr,0,5,-5,22,500,-478,T,153
2600,Lane Side,ztr,1,0,1,161,13,148,CT,153
2601,Lane Side,ztr,1,2,-1,100,200,-100,T,153
2602,Grill,ztr,0,2,-2,32,200,-168,CT,153
2603,Grill,ztr,5,6,-1,443,499,-56,T,153
2604,Top Balcony ,ztr,0,2,-2,80,111,-31,CT,153
2605,Top Balcony ,ztr,4,3,1,400,382,18,T,153
2606,B Site,ztr,0,1,-1,0,100,-100,CT,153
2607,B Site,ztr,3,2,1,123,95,28,T,153
2608,A Bombsite Back Site,ztr,2,4,-2,218,343,-125,CT,153
2609,A Bombsite Back Site,ztr,0,0,0,0,0,0,T,153
2610,2nd Oranges,ztr,0,0,0,0,0,0,CT,153
2611,2nd Oranges,ztr,0,0,0,0,0,0,T,153
2612,Pit Peek Towards Lane,ztr,3,3,0,489,319,170,CT,153
2613,Pit Peek Towards Lane,ztr,2,1,1,231,152,79,T,153
2614,Pit Below Balcony,ztr,2,1,1,126,181,-55,CT,153
2615,Pit Below Balcony,ztr,1,1,0,127,167,-40,T,153
2616,CT Peek Towards B Choke,ztr,1,0,1,12,0,12,CT,153
2617,CT Peek Towards B Choke,ztr,1,1,0,100,100,0,T,153
2618,Banana,ztr,0,0,0,0,0,0,CT,153
2619,Banana,ztr,2,1,1,156,166,-10,T,153
2620,Apartments,ztr,0,0,0,0,0,0,CT,153
2621,Apartments,ztr,0,3,-3,8,307,-299,T,153
2622,Behind Coffins Playing the B Site Cross,ztr,1,1,0,67,185,-118,CT,153
2623,Behind Coffins Playing the B Site Cross,ztr,0,2,-2,0,110,-110,T,153
2624,Pit,ztr,2,0,2,200,81,119,CT,153
2625,Pit,ztr,0,1,-1,40,85,-45,T,153
2626,SecondMid,ztr,1,0,1,100,47,53,CT,153
2627,SecondMid,ztr,0,2,-2,24,279,-255,T,153
2628,Deep Apps Past Hallway,ztr,0,0,0,1,0,1,CT,153
2629,Deep Apps Past Hallway,ztr,0,3,-3,82,315,-233,T,153
2630,A Site,ztr,3,1,2,207,176,31,CT,153
2631,A Site,ztr,1,1,0,97,127,-30,T,153
2632,Top Mid Lane Side ,ztr,1,2,-1,181,200,-19,CT,153
2633,Top Mid Lane Side ,ztr,1,2,-1,133,179,-46,T,153
2634,A Site Behind Middle Boxes/Pillar hidden from Lane,ztr,1,2,-1,121,254,-133,CT,153
2635,A Site Behind Middle Boxes/Pillar hidden from Lane,ztr,0,1,-1,27,56,-29,T,153
2636,Boiler Room,ztr,0,1,-1,0,100,-100,CT,153
2637,Boiler Room,ztr,0,2,-2,20,223,-203,T,153
2638,Quad Box,ztr,0,0,0,0,0,0,CT,153
2639,Quad Box,ztr,0,1,-1,63,97,-34,T,153
2640,Top Hay Bales,ztr,0,0,0,0,0,0,CT,153
2641,Top Hay Bales,ztr,0,2,-2,0,80,-80,T,153
2642,Chokepoint Entering B,ztr,0,0,0,0,0,0,CT,153
2643,Chokepoint Entering B,ztr,3,1,2,272,428,-156,T,153
2644,CT Banana Half Wall Side,ztr,2,1,1,18,100,-82,CT,153
2645,CT Banana Half Wall Side,ztr,1,1,0,125,149,-24,T,153
2646,CT Banana Sandbangs,ztr,0,0,0,0,0,0,CT,153
2647,CT Banana Sandbangs,ztr,1,0,1,26,0,26,T,153
2648,Arch Side,ztr,0,0,0,0,0,0,CT,153
2649,Arch Side,ztr,0,1,-1,27,100,-73,T,153
2650,Back Alley,ztr,0,0,0,0,0,0,CT,153
2651,Back Alley,ztr,1,2,-1,100,268,-168,T,153
2652,B Site Cross for T's Exposed to CT and Quad,ztr,0,0,0,88,12,76,CT,153
2653,B Site Cross for T's Exposed to CT and Quad,ztr,2,3,-1,200,324,-124,T,153
2654,Apps Hallway,ztr,0,1,-1,3,110,-107,CT,153
2655,Apps Hallway,ztr,0,2,-2,0,211,-211,T,153
2656,Boiler Peek to Mid,ztr,0,0,0,44,63,-19,CT,153
2657,Boiler Peek to Mid,ztr,1,2,-1,168,145,23,T,153
2658,Lane Patio,ztr,0,2,-2,162,253,-91,CT,153
2659,Lane Patio,ztr,0,0,0,0,0,0,T,153
2660,Top Mid Chokepoint,ztr,0,1,-1,22,35,-13,CT,153
2661,Top Mid Chokepoint,ztr,1,0,1,135,24,111,T,153
2662,1st Oranges,ztr,2,1,1,259,100,159,CT,153
2663,1st Oranges,ztr,0,0,0,0,0,0,T,153
2664,Chokepoint Entrance onto A site from Library Side,ztr,1,0,1,108,0,108,CT,153
2665,Chokepoint Entrance onto A site from Library Side,ztr,0,0,0,0,0,0,T,153
2666,Graveyard Stairs,ztr,0,1,-1,22,100,-78,CT,153
2667,Graveyard Stairs,ztr,0,0,0,0,0,0,T,153
2668,Dark,ztr,0,0,0,0,0,0,CT,153
2669,Dark,ztr,2,2,0,140,107,33,T,153
2670,CT Outside Construction,ztr,0,1,-1,0,100,-100,CT,153
2671,CT Outside Construction,ztr,0,0,0,0,0,0,T,153
2672,Boiler Side Stairs,ztr,0,0,0,40,28,12,CT,153
2673,Boiler Side Stairs,ztr,0,0,0,33,48,-15,T,153
2674,CT Near Well,ztr,0,1,-1,59,100,-41,CT,153
2675,CT Near Well,ztr,0,0,0,0,22,-22,T,153
2676,Kitchen,ztr,0,1,-1,0,26,-26,CT,153
2677,Kitchen,ztr,0,0,0,0,0,0,T,153
2678,T Ramp Peeking Towards Mid,ztr,0,1,-1,18,100,-82,CT,153
2679,T Ramp Peeking Towards Mid,ztr,0,0,0,0,0,0,T,153
2680,Construction,ztr,0,1,-1,0,100,-100,CT,153
2681,Construction,ztr,0,0,0,0,0,0,T,153
2682,Default Plant A Site,ztr,0,0,0,0,0,0,CT,153
2683,Default Plant A Site,ztr,0,0,0,0,0,0,T,153
2684,Left Side Quadbox Peek for a CT,ztr,0,0,0,0,0,0,CT,153
2685,Left Side Quadbox Peek for a CT,ztr,0,0,0,0,3,-3,T,153
2686,Outside Library,ztr,0,1,-1,0,80,-80,CT,153
2687,Outside Library,ztr,0,0,0,0,0,0,T,153
2688,CT Outside Kitchen,ztr,0,1,-1,0,100,-100,CT,153
2689,CT Outside Kitchen,ztr,0,0,0,0,0,0,T,153
2690,A Site Right Side Middle Pillar,ztr,2,0,2,133,0,133,CT,153
2691,A Site Right Side Middle Pillar,ztr,0,1,-1,7,100,-93,T,153
2692,Deep CT Peeking Towards B Site,ztr,1,0,1,13,0,13,CT,153
2693,Deep CT Peeking Towards B Site,ztr,0,0,0,0,0,0,T,153
2694,Top Coffins,ztr,0,1,-1,0,15,-15,CT,153
2695,Top Coffins,ztr,1,0,1,100,0,100,T,153
2696,CT Tree,ztr,0,1,-1,35,100,-65,CT,153
2697,CT Tree,ztr,0,0,0,0,0,0,T,153
2698,CT Banana Sandbags Right Corner,ztr,0,0,0,0,0,0,CT,153
2699,CT Banana Sandbags Right Corner,ztr,0,1,-1,0,98,-98,T,153
2700,Apartments Hallway Peek from T Side,ztr,0,1,-1,0,2,-2,CT,153
2701,Apartments Hallway Peek from T Side,ztr,0,0,0,0,15,-15,T,153
2702,CT Arch,ztr,0,0,0,0,0,0,CT,153
2703,CT Arch,ztr,0,1,-1,0,100,-100,T,153
2704,Top Mid Arch Side,ztr,0,0,0,56,0,56,CT,153
2705,Top Mid Arch Side,ztr,0,1,-1,27,103,-76,T,153
2706,Lane Side,qikert,1,0,1,100,42,58,CT,141
2707,Lane Side,qikert,2,2,0,181,262,-81,T,141
2708,Chokepoint Entering B,qikert,1,4,-3,259,364,-105,CT,141
2709,Chokepoint Entering B,qikert,1,6,-5,117,432,-315,T,141
2710,Arch Side,qikert,1,3,-2,111,299,-188,CT,141
2711,Arch Side,qikert,0,2,-2,0,228,-228,T,141
2712,Top Mid Chokepoint,qikert,0,0,0,0,0,0,CT,141
2713,Top Mid Chokepoint,qikert,2,4,-2,211,365,-154,T,141
2714,Top Balcony ,qikert,5,3,2,651,390,261,CT,141
2715,Top Balcony ,qikert,1,1,0,100,100,0,T,141
2716,CT Banana Half Wall Side,qikert,1,0,1,154,54,100,CT,141
2717,CT Banana Half Wall Side,qikert,3,1,2,315,268,47,T,141
2718,Middle,qikert,0,0,0,21,83,-62,CT,141
2719,Middle,qikert,0,0,0,0,0,0,T,141
2720,B Site,qikert,1,0,1,9,0,9,CT,141
2721,B Site,qikert,3,4,-1,246,387,-141,T,141
2722,Default Plant A Site,qikert,0,0,0,0,0,0,CT,141
2723,Default Plant A Site,qikert,0,2,-2,0,12,-12,T,141
2724,Top Mid Arch Side,qikert,0,0,0,13,0,13,CT,141
2725,Top Mid Arch Side,qikert,0,1,-1,102,106,-4,T,141
2726,B Site Cross for T's Exposed to CT and Quad,qikert,0,0,0,0,0,0,CT,141
2727,B Site Cross for T's Exposed to CT and Quad,qikert,1,4,-3,177,228,-51,T,141
2728,Behind Coffins Playing the B Site Cross,qikert,0,1,-1,15,101,-86,CT,141
2729,Behind Coffins Playing the B Site Cross,qikert,0,0,0,0,0,0,T,141
2730,1st Oranges,qikert,0,0,0,0,0,0,CT,141
2731,1st Oranges,qikert,0,0,0,0,0,0,T,141
2732,Boiler Peek to Mid,qikert,0,1,-1,50,106,-56,CT,141
2733,Boiler Peek to Mid,qikert,1,0,1,100,27,73,T,141
2734,CT Banana Sandbangs,qikert,1,1,0,78,46,32,CT,141
2735,CT Banana Sandbangs,qikert,0,0,0,3,15,-12,T,141
2736,Logs,qikert,0,0,0,0,0,0,CT,141
2737,Logs,qikert,0,3,-3,314,380,-66,T,141
2738,CT Peek Towards B Choke,qikert,0,1,-1,0,126,-126,CT,141
2739,CT Peek Towards B Choke,qikert,0,0,0,60,92,-32,T,141
2740,Bottom Mid exposed to Top Mid,qikert,0,0,0,0,0,0,CT,141
2741,Bottom Mid exposed to Top Mid,qikert,2,2,0,200,179,21,T,141
2742,Banana,qikert,1,0,1,56,0,56,CT,141
2743,Banana,qikert,4,2,2,676,927,-251,T,141
2744,CT Boost,qikert,0,2,-2,0,174,-174,CT,141
2745,CT Boost,qikert,0,0,0,0,0,0,T,141
2746,T Apps,qikert,0,1,-1,0,100,-100,CT,141
2747,T Apps,qikert,1,0,1,61,0,61,T,141
2748,CT Spawn ,qikert,1,0,1,60,0,60,CT,141
2749,CT Spawn ,qikert,0,2,-2,0,96,-96,T,141
2750,Lane Behind Pillar,qikert,1,0,1,26,0,26,CT,141
2751,Lane Behind Pillar,qikert,0,0,0,0,21,-21,T,141
2752,CT Outside Construction,qikert,0,1,-1,30,100,-70,CT,141
2753,CT Outside Construction,qikert,0,0,0,0,0,0,T,141
2754,Graveyard Stairs,qikert,3,1,2,221,100,121,CT,141
2755,Graveyard Stairs,qikert,0,0,0,0,27,-27,T,141
2756,T Ramp Peeking Towards Mid,qikert,0,0,0,0,0,0,CT,141
2757,T Ramp Peeking Towards Mid,qikert,2,1,1,291,255,36,T,141
2758,Apps Hallway,qikert,0,1,-1,90,100,-10,CT,141
2759,Apps Hallway,qikert,0,0,0,0,0,0,T,141
2760,Pit Peek Towards Lane,qikert,2,1,1,200,118,82,CT,141
2761,Pit Peek Towards Lane,qikert,0,0,0,0,0,0,T,141
2762,Pit,qikert,1,2,-1,236,242,-6,CT,141
2763,Pit,qikert,0,0,0,0,44,-44,T,141
2764,Grill,qikert,0,0,0,37,0,37,CT,141
2765,Grill,qikert,1,1,0,35,165,-130,T,141
2766,Next to Library Cubby,qikert,0,0,0,0,0,0,CT,141
2767,Next to Library Cubby,qikert,0,1,-1,0,75,-75,T,141
2768,A Site Behind Middle Boxes/Pillar hidden from Lane,qikert,1,2,-1,195,147,48,CT,141
2769,A Site Behind Middle Boxes/Pillar hidden from Lane,qikert,0,0,0,0,0,0,T,141
2770,Top Mid Lane Side ,qikert,3,0,3,297,58,239,CT,141
2771,Top Mid Lane Side ,qikert,1,0,1,100,0,100,T,141
2772,Left Side Quadbox Peek for a CT,qikert,0,0,0,0,0,0,CT,141
2773,Left Side Quadbox Peek for a CT,qikert,1,0,1,75,12,63,T,141
2774,A Bombsite Back Site,qikert,0,0,0,0,0,0,CT,141
2775,A Bombsite Back Site,qikert,0,1,-1,14,100,-86,T,141
2776,Lane Patio,qikert,1,2,-1,196,200,-4,CT,141
2777,Lane Patio,qikert,0,0,0,0,27,-27,T,141
2778,Top Hay Bales,qikert,0,0,0,0,0,0,CT,141
2779,Top Hay Bales,qikert,0,0,0,0,0,0,T,141
2780,Quad Box,qikert,0,0,0,0,0,0,CT,141
2781,Quad Box,qikert,0,0,0,0,0,0,T,141
2782,Control,qikert,0,1,-1,0,19,-19,CT,141
2783,Control,qikert,0,0,0,0,30,-30,T,141
2784,CT Near Well,qikert,0,0,0,0,0,0,CT,141
2785,CT Near Well,qikert,0,1,-1,0,100,-100,T,141
2786,CT Tree,qikert,0,1,-1,0,100,-100,CT,141
2787,CT Tree,qikert,0,0,0,0,0,0,T,141
2788,Front Coffins,qikert,1,1,0,39,115,-76,CT,141
2789,Front Coffins,qikert,0,0,0,0,0,0,T,141
2790,BackDoor,qikert,0,0,0,0,0,0,CT,141
2791,BackDoor,qikert,0,1,-1,0,100,-100,T,141
2792,Bottom Mid Banana,qikert,0,0,0,0,0,0,CT,141
2793,Bottom Mid Banana,qikert,1,0,1,109,70,39,T,141
2794,SecondMid,qikert,0,1,-1,37,100,-63,CT,141
2795,SecondMid,qikert,0,0,0,0,1,-1,T,141
2796,CT Banana Close Left Half Wall,qikert,0,0,0,0,0,0,CT,141
2797,CT Banana Close Left Half Wall,qikert,0,0,0,0,0,0,T,141
2798,Pit Below Balcony,qikert,0,1,-1,0,100,-100,CT,141
2799,Pit Below Balcony,qikert,0,0,0,0,0,0,T,141
2800,Outside Library,qikert,0,0,0,14,9,5,CT,141
2801,Outside Library,qikert,0,0,0,0,0,0,T,141
2802,A Bombsite Close Left,qikert,1,0,1,66,0,66,CT,141
2803,A Bombsite Close Left,qikert,1,1,0,100,69,31,T,141
2804,Behind B Site Back Pillar,qikert,0,0,0,0,0,0,CT,141
2805,Behind B Site Back Pillar,qikert,1,0,1,100,0,100,T,141
2806,A Site Behind Default Boxes,qikert,0,0,0,0,0,0,CT,141
2807,A Site Behind Default Boxes,qikert,0,0,0,0,0,0,T,141
2808,Underpass,qikert,0,0,0,0,0,0,CT,141
2809,Underpass,qikert,1,1,0,100,0,100,T,141
2810,Apps T Side Stairs,qikert,0,0,0,0,0,0,CT,141
2811,Apps T Side Stairs,qikert,0,1,-1,0,3,-3,T,141
2812,CT Outside Kitchen,qikert,0,1,-1,0,100,-100,CT,141
2813,CT Outside Kitchen,qikert,0,0,0,0,0,0,T,141
2814,Deep CT Peeking Towards B Site,qikert,1,1,0,147,100,47,CT,141
2815,Deep CT Peeking Towards B Site,qikert,0,0,0,0,0,0,T,141
2816,CT Banana Sandbags Right Corner,qikert,0,0,0,0,0,0,CT,141
2817,CT Banana Sandbags Right Corner,qikert,0,1,-1,0,133,-133,T,141
2818,A Site Left Side Middle Boxes,qikert,1,1,0,8,167,-159,CT,141
2819,A Site Left Side Middle Boxes,qikert,0,0,0,0,0,0,T,141
2820,Chokepoint Entering B,KSCERATO,0,0,0,143,3,140,CT,80
2821,Chokepoint Entering B,KSCERATO,2,4,-2,193,243,-50,T,80
2822,Banana,KSCERATO,1,0,1,100,0,100,CT,80
2823,Banana,KSCERATO,6,3,3,871,856,15,T,80
2824,CT Banana Half Wall Side,KSCERATO,0,0,0,1,0,1,CT,80
2825,CT Banana Half Wall Side,KSCERATO,7,2,5,662,298,364,T,80
2826,Arch Side,KSCERATO,2,4,-2,403,399,4,CT,80
2827,Arch Side,KSCERATO,1,0,1,99,65,34,T,80
2828,Top Mid Arch Side,KSCERATO,0,0,0,0,0,0,CT,80
2829,Top Mid Arch Side,KSCERATO,0,0,0,0,0,0,T,80
2830,Lane Side,KSCERATO,2,0,2,235,95,140,CT,80
2831,Lane Side,KSCERATO,1,1,0,15,100,-85,T,80
2832,CT Banana Barrels,KSCERATO,0,1,-1,58,100,-42,CT,80
2833,CT Banana Barrels,KSCERATO,1,0,1,86,34,52,T,80
2834,CT Peek Towards B Choke,KSCERATO,2,1,1,202,127,75,CT,80
2835,CT Peek Towards B Choke,KSCERATO,1,0,1,46,47,-1,T,80
2836,CT Banana Sandbangs,KSCERATO,4,0,4,257,185,72,CT,80
2837,CT Banana Sandbangs,KSCERATO,1,1,0,55,165,-110,T,80
2838,Grill,KSCERATO,0,0,0,0,0,0,CT,80
2839,Grill,KSCERATO,3,2,1,250,38,212,T,80
2840,Logs,KSCERATO,0,0,0,2,0,2,CT,80
2841,Logs,KSCERATO,3,2,1,312,200,112,T,80
2842,A Bombsite Close Left,KSCERATO,0,1,-1,0,60,-60,CT,80
2843,A Bombsite Close Left,KSCERATO,0,1,-1,74,137,-63,T,80
2844,Deep Apps Past Hallway,KSCERATO,0,0,0,0,0,0,CT,80
2845,Deep Apps Past Hallway,KSCERATO,0,1,-1,43,24,19,T,80
2846,Front Coffins,KSCERATO,1,0,1,82,0,82,CT,80
2847,Front Coffins,KSCERATO,0,0,0,0,0,0,T,80
2848,A Site,KSCERATO,2,1,1,90,187,-97,CT,80
2849,A Site,KSCERATO,0,0,0,0,0,0,T,80
2850,B Site,KSCERATO,0,1,-1,0,133,-133,CT,80
2851,B Site,KSCERATO,0,0,0,0,0,0,T,80
2852,Bottom Mid Banana,KSCERATO,0,0,0,0,0,0,CT,80
2853,Bottom Mid Banana,KSCERATO,1,1,0,99,157,-58,T,80
2854,CT Banana Sandbags Right Corner,KSCERATO,1,1,0,46,56,-10,CT,80
2855,CT Banana Sandbags Right Corner,KSCERATO,0,0,0,0,0,0,T,80
2856,Top Balcony ,KSCERATO,0,0,0,4,0,4,CT,80
2857,Top Balcony ,KSCERATO,0,0,0,27,0,27,T,80
2858,Deep CT Peeking Towards B Site,KSCERATO,0,0,0,0,0,0,CT,80
2859,Deep CT Peeking Towards B Site,KSCERATO,0,0,0,0,0,0,T,80
2860,2nd Oranges,KSCERATO,0,0,0,0,0,0,CT,80
2861,2nd Oranges,KSCERATO,1,1,0,62,100,-38,T,80
2862,Balcony,KSCERATO,1,0,1,4,0,4,CT,80
2863,Balcony,KSCERATO,0,0,0,0,0,0,T,80
2864,Quad Box,KSCERATO,1,0,1,100,0,100,CT,80
2865,Quad Box,KSCERATO,0,0,0,0,0,0,T,80
2866,Default Plant A Site,KSCERATO,1,0,1,100,0,100,CT,80
2867,Default Plant A Site,KSCERATO,0,1,-1,27,69,-42,T,80
2868,Fountain,KSCERATO,0,0,0,0,0,0,CT,80
2869,Fountain,KSCERATO,0,1,-1,0,49,-49,T,80
2870,Construction,KSCERATO,0,0,0,0,0,0,CT,80
2871,Construction,KSCERATO,3,0,3,236,51,185,T,80
2872,CT Outside Kitchen,KSCERATO,1,1,0,173,100,73,CT,80
2873,CT Outside Kitchen,KSCERATO,0,0,0,0,0,0,T,80
2874,Boiler Peek to Mid,KSCERATO,0,0,0,0,0,0,CT,80
2875,Boiler Peek to Mid,KSCERATO,0,1,-1,0,35,-35,T,80
2876,Dark,KSCERATO,0,0,0,0,0,0,CT,80
2877,Dark,KSCERATO,0,0,0,0,0,0,T,80
2878,CT Outside Construction,KSCERATO,0,0,0,8,0,8,CT,80
2879,CT Outside Construction,KSCERATO,0,0,0,0,0,0,T,80
2880,CT Spawn ,KSCERATO,0,0,0,0,0,0,CT,80
2881,CT Spawn ,KSCERATO,0,1,-1,0,67,-67,T,80
2882,LowerMid,KSCERATO,0,0,0,0,0,0,CT,80
2883,LowerMid,KSCERATO,0,1,-1,0,100,-100,T,80
2884,Outside Library,KSCERATO,2,0,2,260,62,198,CT,80
2885,Outside Library,KSCERATO,0,0,0,0,0,0,T,80
2886,Decon,KSCERATO,0,1,-1,0,100,-100,CT,80
2887,Decon,KSCERATO,0,0,0,0,0,0,T,80
2888,Boiler Room,KSCERATO,0,1,-1,44,100,-56,CT,80
2889,Boiler Room,KSCERATO,0,0,0,0,0,0,T,80
2890,Library,KSCERATO,1,1,0,73,100,-27,CT,80
2891,Library,KSCERATO,0,0,0,0,0,0,T,80
2892,CT Outside Arch,KSCERATO,0,0,0,0,0,0,CT,80
2893,CT Outside Arch,KSCERATO,0,0,0,0,0,0,T,80
2894,Top Coffins,KSCERATO,1,0,1,100,0,100,CT,80
2895,Top Coffins,KSCERATO,0,0,0,0,0,0,T,80
2896,Top Mid Chokepoint,KSCERATO,0,0,0,0,0,0,CT,80
2897,Top Mid Chokepoint,KSCERATO,1,0,1,100,0,100,T,80
2898,1st Oranges,KSCERATO,0,0,0,0,0,0,CT,80
2899,1st Oranges,KSCERATO,0,0,0,12,0,12,T,80
2900,Top Mid Lane Side ,KSCERATO,0,0,0,0,0,0,CT,80
2901,Top Mid Lane Side ,KSCERATO,0,1,-1,0,100,-100,T,80
2902,Apartments,KSCERATO,0,0,0,0,0,0,CT,80
2903,Apartments,KSCERATO,0,0,0,0,0,0,T,80
2904,T Ramp Peeking Towards Mid,KSCERATO,0,0,0,0,0,0,CT,80
2905,T Ramp Peeking Towards Mid,KSCERATO,0,0,0,47,171,-124,T,80
2906,Lane Side,Magisk,0,0,0,0,0,0,CT,106
2907,Lane Side,Magisk,0,5,-5,28,333,-305,T,106
2908,Arch Side,Magisk,1,4,-3,245,374,-129,CT,106
2909,Arch Side,Magisk,1,0,1,21,0,21,T,106
2910,Top Balcony ,Magisk,3,2,1,162,143,19,CT,106
2911,Top Balcony ,Magisk,0,1,-1,27,120,-93,T,106
2912,Pit Below Balcony,Magisk,6,3,3,631,325,306,CT,106
2913,Pit Below Balcony,Magisk,0,1,-1,0,80,-80,T,106
2914,Chokepoint Entering B,Magisk,1,3,-2,280,389,-109,CT,106
2915,Chokepoint Entering B,Magisk,4,2,2,368,255,113,T,106
2916,Pit Peek Towards Lane,Magisk,7,4,3,676,492,184,CT,106
2917,Pit Peek Towards Lane,Magisk,0,1,-1,111,100,11,T,106
2918,CT Banana Half Wall Side,Magisk,1,1,0,22,98,-76,CT,106
2919,CT Banana Half Wall Side,Magisk,4,3,1,462,622,-160,T,106
2920,CT Peek Towards B Choke,Magisk,0,2,-2,173,122,51,CT,106
2921,CT Peek Towards B Choke,Magisk,0,0,0,0,0,0,T,106
2922,CT Banana Sandbangs,Magisk,2,1,1,117,135,-18,CT,106
2923,CT Banana Sandbangs,Magisk,1,0,1,93,33,60,T,106
2924,Behind Coffins Playing the B Site Cross,Magisk,0,0,0,0,0,0,CT,106
2925,Behind Coffins Playing the B Site Cross,Magisk,0,1,-1,0,86,-86,T,106
2926,Outside Library,Magisk,2,1,1,210,100,110,CT,106
2927,Outside Library,Magisk,0,0,0,0,0,0,T,106
2928,B Site Cross for T's Exposed to CT and Quad,Magisk,0,0,0,0,0,0,CT,106
2929,B Site Cross for T's Exposed to CT and Quad,Magisk,2,1,1,148,108,40,T,106
2930,B Site,Magisk,1,1,0,76,4,72,CT,106
2931,B Site,Magisk,0,1,-1,0,100,-100,T,106
2932,Top Mid Arch Side,Magisk,2,0,2,238,0,238,CT,106
2933,Top Mid Arch Side,Magisk,1,1,0,154,91,63,T,106
2934,Top Mid Chokepoint,Magisk,0,0,0,20,0,20,CT,106
2935,Top Mid Chokepoint,Magisk,1,2,-1,30,229,-199,T,106
2936,Deep CT Peeking Towards B Site,Magisk,1,1,0,118,120,-2,CT,106
2937,Deep CT Peeking Towards B Site,Magisk,0,0,0,0,0,0,T,106
2938,Front Coffins,Magisk,0,0,0,0,0,0,CT,106
2939,Front Coffins,Magisk,0,0,0,0,0,0,T,106
2940,Lane Patio,Magisk,0,0,0,0,0,0,CT,106
2941,Lane Patio,Magisk,0,0,0,0,0,0,T,106
2942,1st Oranges,Magisk,0,0,0,0,0,0,CT,106
2943,1st Oranges,Magisk,0,0,0,0,0,0,T,106
2944,Graveyard Stairs,Magisk,1,2,-1,183,165,18,CT,106
2945,Graveyard Stairs,Magisk,0,0,0,0,0,0,T,106
2946,Top Mid Lane Side ,Magisk,2,1,1,312,182,130,CT,106
2947,Top Mid Lane Side ,Magisk,3,0,3,322,205,117,T,106
2948,Left Side Quadbox Peek for a CT,Magisk,0,0,0,0,0,0,CT,106
2949,Left Side Quadbox Peek for a CT,Magisk,0,1,-1,0,52,-52,T,106
2950,Deep Apps Past Hallway,Magisk,0,1,-1,0,35,-35,CT,106
2951,Deep Apps Past Hallway,Magisk,0,0,0,1,51,-50,T,106
2952,Logs,Magisk,0,0,0,0,6,-6,CT,106
2953,Logs,Magisk,0,1,-1,114,155,-41,T,106
2954,Banana,Magisk,0,0,0,12,9,3,CT,106
2955,Banana,Magisk,2,2,0,368,336,32,T,106
2956,Chokepoint Entrance onto A site from Library Side,Magisk,1,0,1,54,0,54,CT,106
2957,Chokepoint Entrance onto A site from Library Side,Magisk,2,0,2,200,0,200,T,106
2958,A Site,Magisk,0,0,0,0,0,0,CT,106
2959,A Site,Magisk,1,1,0,23,74,-51,T,106
2960,A Bombsite Close Left,Magisk,0,0,0,0,0,0,CT,106
2961,A Bombsite Close Left,Magisk,0,0,0,5,0,5,T,106
2962,SecondMid,Magisk,1,0,1,64,2,62,CT,106
2963,SecondMid,Magisk,0,0,0,0,0,0,T,106
2964,Pit,Magisk,3,1,2,339,162,177,CT,106
2965,Pit,Magisk,0,0,0,0,0,0,T,106
2966,Boiler Side Stairs,Magisk,1,1,0,100,100,0,CT,106
2967,Boiler Side Stairs,Magisk,0,0,0,0,0,0,T,106
2968,Boiler Room,Magisk,0,0,0,0,30,-30,CT,106
2969,Boiler Room,Magisk,0,0,0,0,0,0,T,106
2970,CT Boost,Magisk,0,1,-1,0,106,-106,CT,106
2971,CT Boost,Magisk,0,0,0,0,0,0,T,106
2972,2nd Oranges,Magisk,0,1,-1,68,196,-128,CT,106
2973,2nd Oranges,Magisk,0,0,0,0,0,0,T,106
2974,Middle,Magisk,0,0,0,15,43,-28,CT,106
2975,Middle,Magisk,0,1,-1,0,14,-14,T,106
2976,Default Plant A Site,Magisk,0,0,0,0,0,0,CT,106
2977,Default Plant A Site,Magisk,0,1,-1,0,0,0,T,106
2978,Grill,Magisk,0,0,0,0,0,0,CT,106
2979,Grill,Magisk,0,1,-1,0,100,-100,T,106
2980,CT Banana Sandbags Right Corner,Magisk,0,0,0,0,0,0,CT,106
2981,CT Banana Sandbags Right Corner,Magisk,0,0,0,0,16,-16,T,106
2982,Underpass,Magisk,0,0,0,0,0,0,CT,106
2983,Underpass,Magisk,0,0,0,0,0,0,T,106
2984,Top Graveyard,Magisk,0,0,0,0,0,0,CT,106
2985,Top Graveyard,Magisk,0,0,0,0,0,0,T,106
2986,Balcony,Magisk,0,1,-1,44,100,-56,CT,106
2987,Balcony,Magisk,0,0,0,0,0,0,T,106
2988,Bottom Mid exposed to Top Mid,Magisk,0,0,0,0,0,0,CT,106
2989,Bottom Mid exposed to Top Mid,Magisk,0,0,0,0,2,-2,T,106
2990,Arch Side CT Corner Peeking Towards Top Mid,Magisk,0,0,0,0,26,-26,CT,106
2991,Arch Side CT Corner Peeking Towards Top Mid,Magisk,0,0,0,0,0,0,T,106
2992,CT Banana Barrels,Magisk,0,0,0,0,0,0,CT,106
2993,CT Banana Barrels,Magisk,0,1,-1,27,53,-26,T,106
2994,T Ramp Peeking Towards Mid,Magisk,0,0,0,0,0,0,CT,106
2995,T Ramp Peeking Towards Mid,Magisk,0,1,-1,79,144,-65,T,106
2996,Chokepoint Entering B,gla1ve,3,2,1,589,203,386,CT,106
2997,Chokepoint Entering B,gla1ve,7,3,4,602,456,146,T,106
2998,Banana,gla1ve,3,4,-1,454,416,38,CT,106
2999,Banana,gla1ve,0,2,-2,109,239,-130,T,106
3000,CT Banana Half Wall Side,gla1ve,3,3,0,507,453,54,CT,106
3001,CT Banana Half Wall Side,gla1ve,2,1,1,183,101,82,T,106
3002,Lane Side,gla1ve,0,0,0,0,0,0,CT,106
3003,Lane Side,gla1ve,1,4,-3,158,400,-242,T,106
3004,Arch Side,gla1ve,1,2,-1,153,176,-23,CT,106
3005,Arch Side,gla1ve,2,1,1,123,143,-20,T,106
3006,CT Peek Towards B Choke,gla1ve,5,1,4,407,260,147,CT,106
3007,CT Peek Towards B Choke,gla1ve,0,2,-2,81,191,-110,T,106
3008,Top Mid Lane Side ,gla1ve,0,1,-1,0,89,-89,CT,106
3009,Top Mid Lane Side ,gla1ve,1,2,-1,37,177,-140,T,106
3010,B Site,gla1ve,3,1,2,374,68,306,CT,106
3011,B Site,gla1ve,1,1,0,100,100,0,T,106
3012,Behind Coffins Playing the B Site Cross,gla1ve,3,2,1,240,243,-3,CT,106
3013,Behind Coffins Playing the B Site Cross,gla1ve,0,0,0,0,0,0,T,106
3014,Top Mid Chokepoint,gla1ve,0,1,-1,0,100,-100,CT,106
3015,Top Mid Chokepoint,gla1ve,2,2,0,309,260,49,T,106
3016,Behind B Site Back Pillar,gla1ve,0,2,-2,109,214,-105,CT,106
3017,Behind B Site Back Pillar,gla1ve,0,1,-1,78,62,16,T,106
3018,CT Arch,gla1ve,0,1,-1,0,121,-121,CT,106
3019,CT Arch,gla1ve,0,0,0,0,0,0,T,106
3020,A Site,gla1ve,0,0,0,0,0,0,CT,106
3021,A Site,gla1ve,0,0,0,0,0,0,T,106
3022,Library,gla1ve,1,0,1,100,54,46,CT,106
3023,Library,gla1ve,1,1,0,82,49,33,T,106
3024,CT Banana Sandbangs,gla1ve,0,1,-1,139,164,-25,CT,106
3025,CT Banana Sandbangs,gla1ve,2,0,2,242,19,223,T,106
3026,Pit,gla1ve,0,1,-1,56,78,-22,CT,106
3027,Pit,gla1ve,0,1,-1,0,100,-100,T,106
3028,Outside Library,gla1ve,0,0,0,0,0,0,CT,106
3029,Outside Library,gla1ve,1,1,0,100,100,0,T,106
3030,Fountain,gla1ve,0,1,-1,35,46,-11,CT,106
3031,Fountain,gla1ve,0,0,0,0,0,0,T,106
3032,Chokepoint Entrance onto A site from Library Side,gla1ve,1,2,-1,100,146,-46,CT,106
3033,Chokepoint Entrance onto A site from Library Side,gla1ve,1,0,1,48,51,-3,T,106
3034,B Site Cross for T's Exposed to CT and Quad,gla1ve,1,0,1,80,0,80,CT,106
3035,B Site Cross for T's Exposed to CT and Quad,gla1ve,0,1,-1,11,70,-59,T,106
3036,Quad Box,gla1ve,1,1,0,130,62,68,CT,106
3037,Quad Box,gla1ve,0,0,0,0,0,0,T,106
3038,Grill,gla1ve,0,1,-1,0,64,-64,CT,106
3039,Grill,gla1ve,2,0,2,189,0,189,T,106
3040,CT Outside Construction,gla1ve,0,0,0,71,36,35,CT,106
3041,CT Outside Construction,gla1ve,0,0,0,0,0,0,T,106
3042,Top Hay Bales,gla1ve,0,1,-1,16,100,-84,CT,106
3043,Top Hay Bales,gla1ve,0,1,-1,153,100,53,T,106
3044,T Ramp Peeking Towards Mid,gla1ve,0,0,0,5,0,5,CT,106
3045,T Ramp Peeking Towards Mid,gla1ve,0,1,-1,0,100,-100,T,106
3046,Pit Below Balcony,gla1ve,0,0,0,0,0,0,CT,106
3047,Pit Below Balcony,gla1ve,0,1,-1,0,53,-53,T,106
3048,Bottom Mid Banana,gla1ve,0,0,0,0,0,0,CT,106
3049,Bottom Mid Banana,gla1ve,0,0,0,33,0,33,T,106
3050,A Site Behind Middle Boxes/Pillar hidden from Lane,gla1ve,0,2,-2,0,191,-191,CT,106
3051,A Site Behind Middle Boxes/Pillar hidden from Lane,gla1ve,1,0,1,19,0,19,T,106
3052,CT Boost,gla1ve,1,1,0,122,72,50,CT,106
3053,CT Boost,gla1ve,0,0,0,0,0,0,T,106
3054,CT Banana Close Left Half Wall,gla1ve,0,1,-1,4,99,-95,CT,106
3055,CT Banana Close Left Half Wall,gla1ve,0,0,0,0,0,0,T,106
3056,Dark,gla1ve,0,1,-1,61,83,-22,CT,106
3057,Dark,gla1ve,0,0,0,0,0,0,T,106
3058,A Bombsite Back Site,gla1ve,0,0,0,0,0,0,CT,106
3059,A Bombsite Back Site,gla1ve,0,0,0,0,0,0,T,106
3060,A Bombsite Close Left,gla1ve,0,0,0,28,7,21,CT,106
3061,A Bombsite Close Left,gla1ve,1,0,1,93,81,12,T,106
3062,Beach,gla1ve,0,0,0,0,0,0,CT,106
3063,Beach,gla1ve,0,1,-1,0,19,-19,T,106
3064,Arch Side CT Corner Peeking Towards Top Mid,gla1ve,0,0,0,0,0,0,CT,106
3065,Arch Side CT Corner Peeking Towards Top Mid,gla1ve,0,0,0,0,0,0,T,106
3066,Left Side Quadbox Peek for a CT,gla1ve,0,1,-1,28,94,-66,CT,106
3067,Left Side Quadbox Peek for a CT,gla1ve,0,0,0,0,61,-61,T,106
3068,Construction Sandbags,gla1ve,0,0,0,0,0,0,CT,106
3069,Construction Sandbags,gla1ve,0,0,0,0,0,0,T,106
3070,Lane Peek Towards Top Mid,gla1ve,0,0,0,0,0,0,CT,106
3071,Lane Peek Towards Top Mid,gla1ve,0,0,0,0,0,0,T,106
3072,Construction,gla1ve,0,1,-1,91,51,40,CT,106
3073,Construction,gla1ve,0,0,0,13,57,-44,T,106
3074,Bottom Mid exposed to Top Mid,gla1ve,0,0,0,0,0,0,CT,106
3075,Bottom Mid exposed to Top Mid,gla1ve,0,0,0,26,0,26,T,106
3076,Boiler Peek to Mid,gla1ve,0,0,0,0,0,0,CT,106
3077,Boiler Peek to Mid,gla1ve,0,1,-1,53,100,-47,T,106
3078,Front Coffins,gla1ve,0,0,0,0,0,0,CT,106
3079,Front Coffins,gla1ve,1,0,1,100,75,25,T,106
3080,Top Balcony ,gla1ve,0,1,-1,50,90,-40,CT,106
3081,Top Balcony ,gla1ve,0,0,0,25,0,25,T,106
3082,TopofMid,gla1ve,0,0,0,0,0,0,CT,106
3083,TopofMid,gla1ve,0,0,0,0,0,0,T,106
3084,Bottom Graveyard,gla1ve,0,0,0,0,0,0,CT,106
3085,Bottom Graveyard,gla1ve,0,0,0,0,0,0,T,106
3086,Middle,gla1ve,0,0,0,0,0,0,CT,106
3087,Middle,gla1ve,0,0,0,108,25,83,T,106
3088,Logs,gla1ve,1,0,1,66,0,66,CT,106
3089,Logs,gla1ve,1,0,1,100,29,71,T,106
3090,Deep CT Peeking Towards B Site,gla1ve,0,1,-1,0,78,-78,CT,106
3091,Deep CT Peeking Towards B Site,gla1ve,0,0,0,0,0,0,T,106
3092,B Site Cross for T's Exposed to CT and Quad,NAF,0,2,-2,208,158,50,CT,85
3093,B Site Cross for T's Exposed to CT and Quad,NAF,2,1,1,190,168,22,T,85
3094,Lane Side,NAF,0,0,0,0,0,0,CT,85
3095,Lane Side,NAF,5,2,3,229,181,48,T,85
3096,Chokepoint Entering B,NAF,1,0,1,272,82,190,CT,85
3097,Chokepoint Entering B,NAF,1,1,0,50,75,-25,T,85
3098,CT Peek Towards B Choke,NAF,4,5,-1,380,468,-88,CT,85
3099,CT Peek Towards B Choke,NAF,0,0,0,0,0,0,T,85
3100,Top Mid Lane Side ,NAF,3,1,2,143,100,43,CT,85
3101,Top Mid Lane Side ,NAF,1,0,1,73,92,-19,T,85
3102,A Site,NAF,0,0,0,0,0,0,CT,85
3103,A Site,NAF,0,1,-1,0,43,-43,T,85
3104,Grill,NAF,1,0,1,73,0,73,CT,85
3105,Grill,NAF,0,2,-2,0,200,-200,T,85
3106,Dark,NAF,4,1,3,349,113,236,CT,85
3107,Dark,NAF,0,1,-1,29,20,9,T,85
3108,Deep Apps Past Hallway,NAF,0,0,0,0,0,0,CT,85
3109,Deep Apps Past Hallway,NAF,2,2,0,279,200,79,T,85
3110,Behind Coffins Playing the B Site Cross,NAF,0,0,0,0,98,-98,CT,85
3111,Behind Coffins Playing the B Site Cross,NAF,0,1,-1,34,100,-66,T,85
3112,Top Coffins,NAF,0,1,-1,42,2,40,CT,85
3113,Top Coffins,NAF,1,1,0,127,98,29,T,85
3114,Top Mid Chokepoint,NAF,0,0,0,0,0,0,CT,85
3115,Top Mid Chokepoint,NAF,2,3,-1,234,267,-33,T,85
3116,Front Coffins,NAF,0,0,0,0,0,0,CT,85
3117,Front Coffins,NAF,0,0,0,0,0,0,T,85
3118,Pit Peek Towards Lane,NAF,0,0,0,0,0,0,CT,85
3119,Pit Peek Towards Lane,NAF,1,1,0,97,100,-3,T,85
3120,Top Balcony ,NAF,0,0,0,0,0,0,CT,85
3121,Top Balcony ,NAF,5,2,3,359,224,135,T,85
3122,B Site,NAF,3,0,3,245,0,245,CT,85
3123,B Site,NAF,0,0,0,0,0,0,T,85
3124,CT Boost,NAF,3,2,1,460,227,233,CT,85
3125,CT Boost,NAF,0,0,0,0,0,0,T,85
3126,1st Oranges,NAF,2,0,2,237,27,210,CT,85
3127,1st Oranges,NAF,0,1,-1,85,121,-36,T,85
3128,Arch Side,NAF,0,0,0,75,64,11,CT,85
3129,Arch Side,NAF,0,1,-1,0,76,-76,T,85
3130,Top Mid Arch Side,NAF,0,0,0,0,0,0,CT,85
3131,Top Mid Arch Side,NAF,1,0,1,100,0,100,T,85
3132,CT Banana Half Wall Side,NAF,3,0,3,342,20,322,CT,85
3133,CT Banana Half Wall Side,NAF,1,1,0,87,113,-26,T,85
3134,Quad Box,NAF,1,2,-1,10,200,-190,CT,85
3135,Quad Box,NAF,0,0,0,0,0,0,T,85
3136,Pit,NAF,0,0,0,0,0,0,CT,85
3137,Pit,NAF,1,1,0,178,100,78,T,85
3138,Banana,NAF,0,0,0,0,0,0,CT,85
3139,Banana,NAF,0,0,0,0,0,0,T,85
3140,CT Banana Sandbangs,NAF,0,0,0,0,13,-13,CT,85
3141,CT Banana Sandbangs,NAF,1,0,1,100,26,74,T,85
3142,A Site Behind Middle Boxes/Pillar hidden from Lane,NAF,0,0,0,0,0,0,CT,85
3143,A Site Behind Middle Boxes/Pillar hidden from Lane,NAF,0,0,0,0,0,0,T,85
3144,Chokepoint Entrance onto A site from Library Side,NAF,0,0,0,38,0,38,CT,85
3145,Chokepoint Entrance onto A site from Library Side,NAF,0,0,0,0,57,-57,T,85
3146,Back Alley,NAF,0,0,0,0,0,0,CT,85
3147,Back Alley,NAF,0,1,-1,46,100,-54,T,85
3148,CT Banana Barrels,NAF,1,0,1,34,0,34,CT,85
3149,CT Banana Barrels,NAF,0,1,-1,26,100,-74,T,85
3150,Construction,NAF,0,1,-1,16,100,-84,CT,85
3151,Construction,NAF,0,0,0,0,0,0,T,85
3152,Arch Side Cubby,NAF,1,0,1,100,0,100,CT,85
3153,Arch Side Cubby,NAF,0,0,0,0,0,0,T,85
3154,A Bombsite Close Left,NAF,0,0,0,0,0,0,CT,85
3155,A Bombsite Close Left,NAF,1,1,0,100,98,2,T,85
3156,DeadTrees,NAF,0,0,0,0,0,0,CT,85
3157,DeadTrees,NAF,0,1,-1,0,100,-100,T,85
3158,Graveyard Stairs,NAF,0,0,0,0,0,0,CT,85
3159,Graveyard Stairs,NAF,0,0,0,0,0,0,T,85
3160,Logs,NAF,0,0,0,0,0,0,CT,85
3161,Logs,NAF,0,0,0,0,0,0,T,85
3162,Bottom Mid Banana,NAF,0,0,0,0,0,0,CT,85
3163,Bottom Mid Banana,NAF,0,0,0,0,0,0,T,85
3164,Bottom Graveyard,NAF,0,0,0,0,0,0,CT,85
3165,Bottom Graveyard,NAF,0,0,0,0,0,0,T,85
3166,Deep CT Peeking Towards B Site,NAF,1,0,1,100,93,7,CT,85
3167,Deep CT Peeking Towards B Site,NAF,0,0,0,0,0,0,T,85
3168,A Site Behind Default Boxes,NAF,0,0,0,0,0,0,CT,85
3169,A Site Behind Default Boxes,NAF,0,0,0,0,21,-21,T,85
3170,CT Arch,NAF,0,0,0,0,0,0,CT,85
3171,CT Arch,NAF,0,0,0,0,0,0,T,85
3172,CT Banana Sandbags Right Corner,NAF,0,0,0,0,0,0,CT,85
3173,CT Banana Sandbags Right Corner,NAF,0,0,0,46,0,46,T,85
3174,SecondMid,NAF,0,0,0,0,0,0,CT,85
3175,SecondMid,NAF,0,1,-1,16,104,-88,T,85
3176,Construction Sandbags,NAF,1,0,1,100,55,45,CT,85
3177,Construction Sandbags,NAF,0,0,0,0,0,0,T,85
3178,2nd Oranges,NAF,0,1,-1,52,100,-48,CT,85
3179,2nd Oranges,NAF,0,0,0,0,0,0,T,85
3180,CT Outside Construction,NAF,1,1,0,78,100,-22,CT,85
3181,CT Outside Construction,NAF,0,0,0,0,0,0,T,85
3182,Middle,NAF,0,0,0,0,3,-3,CT,85
3183,Middle,NAF,0,0,0,0,72,-72,T,85
3184,A Bombsite Back Site,NAF,0,0,0,0,0,0,CT,85
3185,A Bombsite Back Site,NAF,0,0,0,0,0,0,T,85
3186,Apps Hallway,NAF,0,1,-1,0,100,-100,CT,85
3187,Apps Hallway,NAF,1,0,1,100,0,100,T,85
3188,T Ramp Peeking Towards Mid,NAF,0,0,0,0,0,0,CT,85
3189,T Ramp Peeking Towards Mid,NAF,0,0,0,0,0,0,T,85
3190,Lane Side,coldzera,1,2,-1,127,200,-73,CT,74
3191,Lane Side,coldzera,5,0,5,278,22,256,T,74
3192,Chokepoint Entering B,coldzera,1,0,1,54,0,54,CT,74
3193,Chokepoint Entering B,coldzera,0,2,-2,89,223,-134,T,74
3194,Deep Apps Past Hallway,coldzera,1,1,0,123,100,23,CT,74
3195,Deep Apps Past Hallway,coldzera,1,1,0,100,100,0,T,74
3196,A Bombsite Close Left,coldzera,1,0,1,100,0,100,CT,74
3197,A Bombsite Close Left,coldzera,0,1,-1,0,78,-78,T,74
3198,Top Mid Lane Side ,coldzera,4,3,1,579,415,164,CT,74
3199,Top Mid Lane Side ,coldzera,1,1,0,127,100,27,T,74
3200,Top Balcony ,coldzera,1,1,0,59,104,-45,CT,74
3201,Top Balcony ,coldzera,3,2,1,359,275,84,T,74
3202,Banana,coldzera,0,1,-1,0,20,-20,CT,74
3203,Banana,coldzera,1,0,1,53,52,1,T,74
3204,Grill,coldzera,0,0,0,0,0,0,CT,74
3205,Grill,coldzera,0,1,-1,0,53,-53,T,74
3206,Pit Below Balcony,coldzera,1,2,-1,71,105,-34,CT,74
3207,Pit Below Balcony,coldzera,0,0,0,0,0,0,T,74
3208,Pit Peek Towards Lane,coldzera,3,1,2,304,100,204,CT,74
3209,Pit Peek Towards Lane,coldzera,3,2,1,293,119,174,T,74
3210,SecondMid,coldzera,0,0,0,0,0,0,CT,74
3211,SecondMid,coldzera,2,1,1,217,101,116,T,74
3212,Boiler Side Stairs,coldzera,0,1,-1,0,96,-96,CT,74
3213,Boiler Side Stairs,coldzera,0,0,0,0,0,0,T,74
3214,Top Mid Arch Side,coldzera,0,0,0,6,6,0,CT,74
3215,Top Mid Arch Side,coldzera,0,1,-1,27,81,-54,T,74
3216,Pit,coldzera,0,0,0,3,0,3,CT,74
3217,Pit,coldzera,2,1,1,214,138,76,T,74
3218,Front Coffins,coldzera,0,1,-1,0,46,-46,CT,74
3219,Front Coffins,coldzera,1,0,1,100,0,100,T,74
3220,Boiler Room,coldzera,0,0,0,0,0,0,CT,74
3221,Boiler Room,coldzera,0,0,0,0,0,0,T,74
3222,A Site Behind Default Boxes,coldzera,0,1,-1,44,100,-56,CT,74
3223,A Site Behind Default Boxes,coldzera,0,0,0,0,0,0,T,74
3224,B Site Cross for T's Exposed to CT and Quad,coldzera,0,0,0,0,0,0,CT,74
3225,B Site Cross for T's Exposed to CT and Quad,coldzera,0,0,0,0,0,0,T,74
3226,CT Banana Half Wall Side,coldzera,1,0,1,97,55,42,CT,74
3227,CT Banana Half Wall Side,coldzera,0,0,0,0,24,-24,T,74
3228,Chokepoint Entrance onto A site from Library Side,coldzera,1,0,1,94,36,58,CT,74
3229,Chokepoint Entrance onto A site from Library Side,coldzera,0,1,-1,54,100,-46,T,74
3230,Quad Box,coldzera,0,0,0,0,0,0,CT,74
3231,Quad Box,coldzera,0,0,0,0,0,0,T,74
3232,Top Mid Chokepoint,coldzera,1,0,1,62,0,62,CT,74
3233,Top Mid Chokepoint,coldzera,0,0,0,0,0,0,T,74
3234,Boiler Peek to Mid,coldzera,1,0,1,100,0,100,CT,74
3235,Boiler Peek to Mid,coldzera,0,2,-2,47,200,-153,T,74
3236,T Apps Bridge ,coldzera,0,0,0,0,0,0,CT,74
3237,T Apps Bridge ,coldzera,0,0,0,3,0,3,T,74
3238,Dark,coldzera,3,0,3,131,0,131,CT,74
3239,Dark,coldzera,1,1,0,50,92,-42,T,74
3240,CT Peek Towards B Choke,coldzera,4,0,4,323,0,323,CT,74
3241,CT Peek Towards B Choke,coldzera,0,0,0,0,0,0,T,74
3242,CT Boost,coldzera,0,0,0,0,0,0,CT,74
3243,CT Boost,coldzera,0,1,-1,0,100,-100,T,74
3244,A Site,coldzera,0,0,0,0,0,0,CT,74
3245,A Site,coldzera,0,0,0,0,0,0,T,74
3246,Apps Hallway,coldzera,0,0,0,0,0,0,CT,74
3247,Apps Hallway,coldzera,1,1,0,106,130,-24,T,74
3248,A Bombsite Back Site,coldzera,0,0,0,0,0,0,CT,74
3249,A Bombsite Back Site,coldzera,0,0,0,0,0,0,T,74
3250,Outside Library,coldzera,1,0,1,100,0,100,CT,74
3251,Outside Library,coldzera,0,0,0,0,0,0,T,74
3252,Bottom Mid exposed to Top Mid,coldzera,1,0,1,6,0,6,CT,74
3253,Bottom Mid exposed to Top Mid,coldzera,0,0,0,59,26,33,T,74
3254,LowerMid,coldzera,0,0,0,0,0,0,CT,74
3255,LowerMid,coldzera,3,1,2,300,100,200,T,74
3256,1st Oranges,coldzera,0,0,0,0,0,0,CT,74
3257,1st Oranges,coldzera,0,0,0,0,0,0,T,74
3258,Middle,coldzera,0,0,0,0,0,0,CT,74
3259,Middle,coldzera,0,0,0,0,7,-7,T,74
3260,Top Hay Bales,coldzera,0,0,0,0,0,0,CT,74
3261,Top Hay Bales,coldzera,0,0,0,0,0,0,T,74
3262,A Site Right Side Middle Pillar,coldzera,0,1,-1,0,100,-100,CT,74
3263,A Site Right Side Middle Pillar,coldzera,0,0,0,0,0,0,T,74
3264,Apartments Hallway Peek from T Side,coldzera,0,0,0,0,0,0,CT,74
3265,Apartments Hallway Peek from T Side,coldzera,0,0,0,0,0,0,T,74
3266,Bottom Mid Banana,coldzera,0,0,0,0,0,0,CT,74
3267,Bottom Mid Banana,coldzera,1,1,0,99,100,-1,T,74
3268,Apartments,coldzera,0,0,0,0,4,-4,CT,74
3269,Apartments,coldzera,0,0,0,0,0,0,T,74
3270,Behind Coffins Playing the B Site Cross,coldzera,1,0,1,87,0,87,CT,74
3271,Behind Coffins Playing the B Site Cross,coldzera,0,0,0,0,0,0,T,74
3272,Right Side Quadbox Peek for a CT,coldzera,0,0,0,0,0,0,CT,74
3273,Right Side Quadbox Peek for a CT,coldzera,0,0,0,0,0,0,T,74
3274,Top Graveyard,coldzera,0,0,0,0,0,0,CT,74
3275,Top Graveyard,coldzera,0,0,0,0,0,0,T,74
3276,Top Coffins,coldzera,0,1,-1,0,100,-100,CT,74
3277,Top Coffins,coldzera,0,0,0,0,0,0,T,74
3278,CT Arch,coldzera,0,0,0,0,0,0,CT,74
3279,CT Arch,coldzera,0,0,0,0,0,0,T,74
3280,CT Banana Sandbags Right Corner,coldzera,0,0,0,0,0,0,CT,74
3281,CT Banana Sandbags Right Corner,coldzera,2,1,1,119,100,19,T,74
3282,CT Outside Construction,coldzera,0,1,-1,0,100,-100,CT,74
3283,CT Outside Construction,coldzera,0,0,0,0,0,0,T,74
3284,Arch Side,coldzera,0,1,-1,53,100,-47,CT,74
3285,Arch Side,coldzera,1,0,1,100,0,100,T,74
3286,T Ramp Peeking Towards Mid,coldzera,0,0,0,0,0,0,CT,74
3287,T Ramp Peeking Towards Mid,coldzera,0,1,-1,44,100,-56,T,74
3288,Top Mid Chokepoint,broky,0,1,-1,0,100,-100,CT,74
3289,Top Mid Chokepoint,broky,2,3,-1,322,294,28,T,74
3290,CT Banana Half Wall Side,broky,0,0,0,0,0,0,CT,74
3291,CT Banana Half Wall Side,broky,1,1,0,228,161,67,T,74
3292,A Bombsite Close Left,broky,0,2,-2,24,197,-173,CT,74
3293,A Bombsite Close Left,broky,0,1,-1,0,100,-100,T,74
3294,Top Mid Lane Side ,broky,0,0,0,0,61,-61,CT,74
3295,Top Mid Lane Side ,broky,1,1,0,101,154,-53,T,74
3296,Lane Side,broky,2,0,2,61,19,42,CT,74
3297,Lane Side,broky,2,2,0,209,224,-15,T,74
3298,A Site,broky,0,0,0,0,0,0,CT,74
3299,A Site,broky,1,0,1,47,78,-31,T,74
3300,Banana,broky,0,0,0,0,0,0,CT,74
3301,Banana,broky,2,1,1,113,208,-95,T,74
3302,Top Mid Arch Side,broky,2,0,2,206,54,152,CT,74
3303,Top Mid Arch Side,broky,0,0,0,25,0,25,T,74
3304,Behind Coffins Playing the B Site Cross,broky,1,1,0,100,100,0,CT,74
3305,Behind Coffins Playing the B Site Cross,broky,1,0,1,73,0,73,T,74
3306,B Site,broky,0,0,0,0,0,0,CT,74
3307,B Site,broky,0,3,-3,54,232,-178,T,74
3308,Chokepoint Entrance onto A site from Library Side,broky,0,0,0,0,0,0,CT,74
3309,Chokepoint Entrance onto A site from Library Side,broky,0,1,-1,0,100,-100,T,74
3310,Chokepoint Entering B,broky,4,0,4,276,60,216,CT,74
3311,Chokepoint Entering B,broky,2,1,1,189,141,48,T,74
3312,Arch Side Cubby,broky,1,1,0,59,100,-41,CT,74
3313,Arch Side Cubby,broky,1,0,1,100,0,100,T,74
3314,Apps T Side Stairs,broky,0,1,-1,30,30,0,CT,74
3315,Apps T Side Stairs,broky,0,0,0,0,0,0,T,74
3316,Deep CT Peeking Towards B Site,broky,0,1,-1,0,100,-100,CT,74
3317,Deep CT Peeking Towards B Site,broky,0,0,0,0,0,0,T,74
3318,Right Side Quadbox Peek for a CT,broky,0,0,0,0,0,0,CT,74
3319,Right Side Quadbox Peek for a CT,broky,1,0,1,100,14,86,T,74
3320,A Site Behind Middle Boxes/Pillar hidden from Lane,broky,2,1,1,66,99,-33,CT,74
3321,A Site Behind Middle Boxes/Pillar hidden from Lane,broky,0,0,0,0,0,0,T,74
3322,CT Tree,broky,0,0,0,0,0,0,CT,74
3323,CT Tree,broky,0,0,0,0,0,0,T,74
3324,Logs,broky,0,0,0,0,0,0,CT,74
3325,Logs,broky,1,2,-1,64,241,-177,T,74
3326,Outside Library,broky,1,0,1,83,0,83,CT,74
3327,Outside Library,broky,0,0,0,0,0,0,T,74
3328,CT Peek Towards B Choke,broky,0,1,-1,90,100,-10,CT,74
3329,CT Peek Towards B Choke,broky,0,0,0,0,0,0,T,74
3330,CT Speed Way,broky,0,0,0,0,0,0,CT,74
3331,CT Speed Way,broky,0,0,0,0,0,0,T,74
3332,Middle,broky,0,0,0,0,0,0,CT,74
3333,Middle,broky,0,0,0,0,7,-7,T,74
3334,Boiler Side Stairs,broky,0,0,0,0,0,0,CT,74
3335,Boiler Side Stairs,broky,0,0,0,0,0,0,T,74
3336,Top Balcony ,broky,0,0,0,20,0,20,CT,74
3337,Top Balcony ,broky,0,0,0,0,0,0,T,74
3338,2nd Oranges,broky,0,0,0,0,0,0,CT,74
3339,2nd Oranges,broky,2,1,1,196,158,38,T,74
3340,A Site Right Side Middle Pillar,broky,2,0,2,180,54,126,CT,74
3341,A Site Right Side Middle Pillar,broky,1,0,1,60,0,60,T,74
3342,1st Oranges,broky,0,0,0,0,0,0,CT,74
3343,1st Oranges,broky,0,1,-1,24,71,-47,T,74
3344,CT Banana Barrels,broky,0,0,0,0,0,0,CT,74
3345,CT Banana Barrels,broky,0,0,0,0,12,-12,T,74
3346,Underpass,broky,0,0,0,0,0,0,CT,74
3347,Underpass,broky,0,0,0,0,10,-10,T,74
3348,CTSideLower,broky,0,1,-1,0,66,-66,CT,74
3349,CTSideLower,broky,0,0,0,0,0,0,T,74
3350,Grill,broky,1,0,1,47,0,47,CT,74
3351,Grill,broky,0,0,0,0,0,0,T,74
3352,Apartments Hallway Peek from T Side,broky,1,0,1,100,0,100,CT,74
3353,Apartments Hallway Peek from T Side,broky,0,1,-1,1,100,-99,T,74
3354,Pit Below Balcony,broky,0,0,0,0,0,0,CT,74
3355,Pit Below Balcony,broky,0,1,-1,0,100,-100,T,74
3356,Bottom Mid exposed to Top Mid,broky,0,0,0,47,0,47,CT,74
3357,Bottom Mid exposed to Top Mid,broky,0,0,0,0,0,0,T,74
3358,Behind B Site Back Pillar,broky,0,0,0,0,0,0,CT,74
3359,Behind B Site Back Pillar,broky,0,0,0,0,0,0,T,74
3360,A Site Behind Default Boxes,broky,0,1,-1,73,76,-3,CT,74
3361,A Site Behind Default Boxes,broky,0,0,0,0,0,0,T,74
3362,CT Near Well,broky,0,0,0,0,0,0,CT,74
3363,CT Near Well,broky,0,0,0,0,0,0,T,74
3364,Bottom Mid Banana,broky,0,0,0,0,0,0,CT,74
3365,Bottom Mid Banana,broky,1,0,1,100,0,100,T,74
3366,Arch Side,broky,6,1,5,500,124,376,CT,74
3367,Arch Side,broky,2,0,2,121,0,121,T,74
3368,CT Banana Sandbangs,broky,1,1,0,100,100,0,CT,74
3369,CT Banana Sandbangs,broky,0,0,0,11,0,11,T,74
3370,CT Arch,broky,0,0,0,0,1,-1,CT,74
3371,CT Arch,broky,0,0,0,0,0,0,T,74
3372,Pit Peek Towards Lane,broky,1,0,1,56,0,56,CT,74
3373,Pit Peek Towards Lane,broky,0,1,-1,0,51,-51,T,74
3374,CT Outside Arch,broky,0,1,-1,49,100,-51,CT,74
3375,CT Outside Arch,broky,0,0,0,0,0,0,T,74
3376,Construction,broky,0,0,0,0,0,0,CT,74
3377,Construction,broky,1,0,1,100,0,100,T,74
3378,Graveyard Stairs,broky,2,0,2,171,0,171,CT,74
3379,Graveyard Stairs,broky,0,0,0,0,0,0,T,74
3380,Dark,broky,0,1,-1,0,44,-44,CT,74
3381,Dark,broky,1,0,1,98,0,98,T,74
3382,CT Outside Construction,broky,1,1,0,100,96,4,CT,74
3383,CT Outside Construction,broky,2,0,2,200,0,200,T,74
3384,T Ramp Peeking Towards Mid,broky,1,0,1,58,80,-22,CT,74
3385,T Ramp Peeking Towards Mid,broky,0,1,-1,123,188,-65,T,74
3386,Lane Side,dupreeh,1,4,-3,176,400,-224,CT,106
3387,Lane Side,dupreeh,1,4,-3,127,440,-313,T,106
3388,Arch Side,dupreeh,1,1,0,142,100,42,CT,106
3389,Arch Side,dupreeh,3,1,2,185,144,41,T,106
3390,Top Balcony ,dupreeh,0,1,-1,76,100,-24,CT,106
3391,Top Balcony ,dupreeh,0,2,-2,0,200,-200,T,106
3392,Top Mid Lane Side ,dupreeh,0,1,-1,9,134,-125,CT,106
3393,Top Mid Lane Side ,dupreeh,0,2,-2,44,151,-107,T,106
3394,Top Mid Arch Side,dupreeh,1,0,1,83,0,83,CT,106
3395,Top Mid Arch Side,dupreeh,5,3,2,486,226,260,T,106
3396,Chokepoint Entering B,dupreeh,1,3,-2,74,300,-226,CT,106
3397,Chokepoint Entering B,dupreeh,1,1,0,79,164,-85,T,106
3398,B Site,dupreeh,2,0,2,225,63,162,CT,106
3399,B Site,dupreeh,1,2,-1,127,200,-73,T,106
3400,CT Peek Towards B Choke,dupreeh,3,1,2,250,126,124,CT,106
3401,CT Peek Towards B Choke,dupreeh,1,1,0,169,56,113,T,106
3402,B Site Cross for T's Exposed to CT and Quad,dupreeh,1,1,0,9,100,-91,CT,106
3403,B Site Cross for T's Exposed to CT and Quad,dupreeh,1,1,0,60,155,-95,T,106
3404,Top Mid Chokepoint,dupreeh,0,2,-2,0,200,-200,CT,106
3405,Top Mid Chokepoint,dupreeh,1,1,0,100,100,0,T,106
3406,CT Banana Half Wall Side,dupreeh,0,0,0,0,0,0,CT,106
3407,CT Banana Half Wall Side,dupreeh,1,1,0,88,115,-27,T,106
3408,Grill,dupreeh,0,0,0,0,0,0,CT,106
3409,Grill,dupreeh,0,2,-2,14,139,-125,T,106
3410,T Apps,dupreeh,0,0,0,0,0,0,CT,106
3411,T Apps,dupreeh,3,0,3,300,82,218,T,106
3412,Outside Library,dupreeh,1,1,0,127,181,-54,CT,106
3413,Outside Library,dupreeh,0,1,-1,52,100,-48,T,106
3414,Banana,dupreeh,0,0,0,22,60,-38,CT,106
3415,Banana,dupreeh,0,1,-1,26,164,-138,T,106
3416,T Ramp Peeking Towards Mid,dupreeh,0,1,-1,0,47,-47,CT,106
3417,T Ramp Peeking Towards Mid,dupreeh,0,0,0,58,0,58,T,106
3418,A Site Right Side Middle Pillar,dupreeh,0,2,-2,3,144,-141,CT,106
3419,A Site Right Side Middle Pillar,dupreeh,2,1,1,111,49,62,T,106
3420,Library,dupreeh,0,1,-1,128,100,28,CT,106
3421,Library,dupreeh,0,0,0,0,0,0,T,106
3422,Back Alley,dupreeh,0,0,0,0,0,0,CT,106
3423,Back Alley,dupreeh,0,0,0,0,0,0,T,106
3424,Behind Coffins Playing the B Site Cross,dupreeh,0,2,-2,68,137,-69,CT,106
3425,Behind Coffins Playing the B Site Cross,dupreeh,0,0,0,0,0,0,T,106
3426,Front Coffins,dupreeh,0,0,0,0,0,0,CT,106
3427,Front Coffins,dupreeh,0,0,0,0,0,0,T,106
3428,Bottom Mid exposed to Top Mid,dupreeh,0,2,-2,0,200,-200,CT,106
3429,Bottom Mid exposed to Top Mid,dupreeh,0,0,0,0,0,0,T,106
3430,Apps Hallway,dupreeh,0,0,0,0,0,0,CT,106
3431,Apps Hallway,dupreeh,0,1,-1,0,100,-100,T,106
3432,Default Plant A Site,dupreeh,0,0,0,0,0,0,CT,106
3433,Default Plant A Site,dupreeh,1,1,0,27,94,-67,T,106
3434,Pit Below Balcony,dupreeh,1,2,-1,25,200,-175,CT,106
3435,Pit Below Balcony,dupreeh,0,0,0,0,0,0,T,106
3436,A Bombsite Close Left,dupreeh,4,1,3,253,156,97,CT,106
3437,A Bombsite Close Left,dupreeh,0,0,0,0,0,0,T,106
3438,Pit,dupreeh,2,1,1,229,100,129,CT,106
3439,Pit,dupreeh,0,0,0,0,0,0,T,106
3440,Construction,dupreeh,0,2,-2,64,200,-136,CT,106
3441,Construction,dupreeh,1,0,1,58,0,58,T,106
3442,Boiler Room,dupreeh,0,0,0,0,28,-28,CT,106
3443,Boiler Room,dupreeh,1,1,0,100,114,-14,T,106
3444,Pit Peek Towards Lane,dupreeh,0,0,0,0,0,0,CT,106
3445,Pit Peek Towards Lane,dupreeh,0,0,0,0,0,0,T,106
3446,Next to Library Cubby,dupreeh,1,0,1,100,151,-51,CT,106
3447,Next to Library Cubby,dupreeh,0,0,0,0,0,0,T,106
3448,Lane Behind Pillar,dupreeh,1,1,0,122,100,22,CT,106
3449,Lane Behind Pillar,dupreeh,0,0,0,0,0,0,T,106
3450,LowerMid,dupreeh,0,0,0,0,0,0,CT,106
3451,LowerMid,dupreeh,0,1,-1,20,100,-80,T,106
3452,Quad Box,dupreeh,0,0,0,0,0,0,CT,106
3453,Quad Box,dupreeh,0,1,-1,0,51,-51,T,106
3454,CT Arch,dupreeh,1,0,1,181,0,181,CT,106
3455,CT Arch,dupreeh,0,1,-1,27,100,-73,T,106
3456,CT Banana Sandbangs,dupreeh,0,1,-1,0,100,-100,CT,106
3457,CT Banana Sandbangs,dupreeh,2,0,2,239,0,239,T,106
3458,T Apps Bridge ,dupreeh,0,0,0,0,0,0,CT,106
3459,T Apps Bridge ,dupreeh,0,0,0,0,0,0,T,106
3460,SecondMid,dupreeh,0,0,0,0,0,0,CT,106
3461,SecondMid,dupreeh,1,0,1,118,99,19,T,106
3462,Deep CT Peeking Towards B Site,dupreeh,0,0,0,26,0,26,CT,106
3463,Deep CT Peeking Towards B Site,dupreeh,1,0,1,100,0,100,T,106
3464,CT Outside Construction,dupreeh,1,1,0,10,66,-56,CT,106
3465,CT Outside Construction,dupreeh,0,0,0,0,0,0,T,106
3466,Behind B Site Back Pillar,dupreeh,0,0,0,0,0,0,CT,106
3467,Behind B Site Back Pillar,dupreeh,0,1,-1,26,100,-74,T,106
3468,A Site Behind Default Boxes,dupreeh,0,1,-1,8,100,-92,CT,106
3469,A Site Behind Default Boxes,dupreeh,0,0,0,0,0,0,T,106
3470,Boiler Side Stairs,dupreeh,0,0,0,0,0,0,CT,106
3471,Boiler Side Stairs,dupreeh,0,0,0,0,0,0,T,106
3472,Apartments Hallway Peek from T Side,dupreeh,0,0,0,0,0,0,CT,106
3473,Apartments Hallway Peek from T Side,dupreeh,1,1,0,100,100,0,T,106
3474,Apartments,dupreeh,0,0,0,0,10,-10,CT,106
3475,Apartments,dupreeh,0,1,-1,0,100,-100,T,106
3476,Underpass,dupreeh,0,0,0,0,0,0,CT,106
3477,Underpass,dupreeh,0,0,0,0,29,-29,T,106
3478,Middle,dupreeh,3,1,2,239,153,86,CT,106
3479,Middle,dupreeh,0,0,0,13,0,13,T,106
3480,CT Banana Sandbags Right Corner,dupreeh,0,0,0,0,0,0,CT,106
3481,CT Banana Sandbags Right Corner,dupreeh,0,0,0,32,0,32,T,106
3482,2nd Oranges,dupreeh,0,0,0,0,0,0,CT,106
3483,2nd Oranges,dupreeh,0,0,0,0,0,0,T,106
3484,A Bombsite Back Site,dupreeh,1,0,1,100,0,100,CT,106
3485,A Bombsite Back Site,dupreeh,0,0,0,0,0,0,T,106
3486,A Site,dupreeh,0,1,-1,0,45,-45,CT,106
3487,A Site,dupreeh,0,0,0,0,0,0,T,106
3488,Lane Side,Surreal,2,2,0,261,337,-76,CT,133
3489,Lane Side,Surreal,0,3,-3,41,270,-229,T,133
3490,B Site,Surreal,1,1,0,23,138,-115,CT,133
3491,B Site,Surreal,1,4,-3,166,260,-94,T,133
3492,Top Mid Lane Side ,Surreal,4,4,0,332,271,61,CT,133
3493,Top Mid Lane Side ,Surreal,2,2,0,221,250,-29,T,133
3494,Deep Apps Past Hallway,Surreal,2,1,1,176,100,76,CT,133
3495,Deep Apps Past Hallway,Surreal,2,6,-4,327,677,-350,T,133
3496,Top Balcony ,Surreal,1,2,-1,79,197,-118,CT,133
3497,Top Balcony ,Surreal,4,4,0,427,307,120,T,133
3498,Chokepoint Entering B,Surreal,1,1,0,52,45,7,CT,133
3499,Chokepoint Entering B,Surreal,3,4,-1,346,406,-60,T,133
3500,A Bombsite Close Left,Surreal,3,2,1,413,236,177,CT,133
3501,A Bombsite Close Left,Surreal,0,0,0,0,28,-28,T,133
3502,CT Peek Towards B Choke,Surreal,1,3,-2,151,218,-67,CT,133
3503,CT Peek Towards B Choke,Surreal,1,0,1,65,8,57,T,133
3504,Pit Below Balcony,Surreal,2,3,-1,215,300,-85,CT,133
3505,Pit Below Balcony,Surreal,0,1,-1,0,99,-99,T,133
3506,Pit Peek Towards Lane,Surreal,3,3,0,357,368,-11,CT,133
3507,Pit Peek Towards Lane,Surreal,1,1,0,123,46,77,T,133
3508,Top Mid Chokepoint,Surreal,0,0,0,0,0,0,CT,133
3509,Top Mid Chokepoint,Surreal,0,1,-1,60,126,-66,T,133
3510,Top Mid Arch Side,Surreal,0,0,0,0,0,0,CT,133
3511,Top Mid Arch Side,Surreal,1,2,-1,36,180,-144,T,133
3512,Arch Side,Surreal,0,1,-1,67,100,-33,CT,133
3513,Arch Side,Surreal,0,2,-2,99,200,-101,T,133
3514,CT Banana Half Wall Side,Surreal,1,0,1,6,0,6,CT,133
3515,CT Banana Half Wall Side,Surreal,0,0,0,0,0,0,T,133
3516,CT Outside Construction,Surreal,1,2,-1,38,211,-173,CT,133
3517,CT Outside Construction,Surreal,0,0,0,0,0,0,T,133
3518,Outside Library,Surreal,0,0,0,0,0,0,CT,133
3519,Outside Library,Surreal,0,1,-1,31,98,-67,T,133
3520,Banana,Surreal,1,0,1,100,0,100,CT,133
3521,Banana,Surreal,0,3,-3,0,162,-162,T,133
3522,Middle,Surreal,0,0,0,0,0,0,CT,133
3523,Middle,Surreal,2,2,0,231,222,9,T,133
3524,Top Coffins,Surreal,0,0,0,0,0,0,CT,133
3525,Top Coffins,Surreal,0,0,0,0,0,0,T,133
3526,Boiler Side Stairs,Surreal,1,1,0,148,183,-35,CT,133
3527,Boiler Side Stairs,Surreal,0,0,0,0,7,-7,T,133
3528,T Ramp Peeking Towards Mid,Surreal,0,0,0,0,0,0,CT,133
3529,T Ramp Peeking Towards Mid,Surreal,0,1,-1,0,26,-26,T,133
3530,Default Plant A Site,Surreal,0,0,0,0,0,0,CT,133
3531,Default Plant A Site,Surreal,0,0,0,0,0,0,T,133
3532,Left Side Quadbox Peek for a CT,Surreal,0,0,0,22,0,22,CT,133
3533,Left Side Quadbox Peek for a CT,Surreal,0,1,-1,0,100,-100,T,133
3534,Chokepoint Entrance onto A site from Library Side,Surreal,0,1,-1,0,100,-100,CT,133
3535,Chokepoint Entrance onto A site from Library Side,Surreal,0,0,0,0,0,0,T,133
3536,Behind B Site Back Pillar,Surreal,0,0,0,0,0,0,CT,133
3537,Behind B Site Back Pillar,Surreal,0,0,0,0,0,0,T,133
3538,Behind Coffins Playing the B Site Cross,Surreal,1,1,0,156,127,29,CT,133
3539,Behind Coffins Playing the B Site Cross,Surreal,0,0,0,4,0,4,T,133
3540,Bottom Mid exposed to Top Mid,Surreal,0,0,0,0,0,0,CT,133
3541,Bottom Mid exposed to Top Mid,Surreal,0,0,0,2,0,2,T,133
3542,Boiler Room,Surreal,1,0,1,64,0,64,CT,133
3543,Boiler Room,Surreal,1,0,1,130,10,120,T,133
3544,Lane Patio,Surreal,1,2,-1,106,156,-50,CT,133
3545,Lane Patio,Surreal,0,0,0,4,0,4,T,133
3546,Balcony,Surreal,0,0,0,0,0,0,CT,133
3547,Balcony,Surreal,0,0,0,0,0,0,T,133
3548,CT Banana Barrels,Surreal,0,0,0,0,0,0,CT,133
3549,CT Banana Barrels,Surreal,0,0,0,0,0,0,T,133
3550,Grill,Surreal,0,0,0,0,0,0,CT,133
3551,Grill,Surreal,1,1,0,148,235,-87,T,133
3552,Arch Side Cubby,Surreal,0,0,0,0,0,0,CT,133
3553,Arch Side Cubby,Surreal,0,0,0,0,0,0,T,133
3554,1st Oranges,Surreal,1,0,1,46,0,46,CT,133
3555,1st Oranges,Surreal,0,0,0,0,0,0,T,133
3556,CT Arch,Surreal,0,0,0,0,0,0,CT,133
3557,CT Arch,Surreal,0,1,-1,0,100,-100,T,133
3558,Lane Peek Towards Top Mid,Surreal,2,1,1,224,100,124,CT,133
3559,Lane Peek Towards Top Mid,Surreal,0,0,0,0,0,0,T,133
3560,Logs,Surreal,1,0,1,100,0,100,CT,133
3561,Logs,Surreal,0,1,-1,0,53,-53,T,133
3562,Pit,Surreal,0,1,-1,39,17,22,CT,133
3563,Pit,Surreal,0,0,0,0,31,-31,T,133
3564,Back Alley,Surreal,0,0,0,0,0,0,CT,133
3565,Back Alley,Surreal,0,1,-1,92,100,-8,T,133
3566,T Apps Bridge ,Surreal,0,0,0,0,0,0,CT,133
3567,T Apps Bridge ,Surreal,0,1,-1,0,55,-55,T,133
3568,SecondMid,Surreal,0,0,0,0,0,0,CT,133
3569,SecondMid,Surreal,2,1,1,232,146,86,T,133
3570,Graveyard Stairs,Surreal,0,0,0,0,0,0,CT,133
3571,Graveyard Stairs,Surreal,0,0,0,0,0,0,T,133
3572,CT Banana Sandbangs,Surreal,0,0,0,0,0,0,CT,133
3573,CT Banana Sandbangs,Surreal,0,1,-1,112,100,12,T,133
3574,Construction,Surreal,1,0,1,38,0,38,CT,133
3575,Construction,Surreal,1,0,1,100,69,31,T,133
3576,Boiler Peek to Mid,Surreal,0,0,0,16,62,-46,CT,133
3577,Boiler Peek to Mid,Surreal,0,0,0,100,35,65,T,133
3578,Apartments Hallway Peek from T Side,Surreal,0,0,0,0,0,0,CT,133
3579,Apartments Hallway Peek from T Side,Surreal,0,0,0,0,0,0,T,133
3580,Apartments,Surreal,0,0,0,0,0,0,CT,133
3581,Apartments,Surreal,0,0,0,0,0,0,T,133
3582,Apps T Side Stairs,Surreal,0,0,0,0,0,0,CT,133
3583,Apps T Side Stairs,Surreal,0,1,-1,89,136,-47,T,133
3584,TopofMid,Surreal,0,0,0,0,0,0,CT,133
3585,TopofMid,Surreal,1,0,1,19,33,-14,T,133
3586,Dark,Surreal,0,0,0,0,0,0,CT,133
3587,Dark,Surreal,0,1,-1,44,43,1,T,133
3588,2nd Oranges,Surreal,0,1,-1,0,100,-100,CT,133
3589,2nd Oranges,Surreal,1,0,1,158,9,149,T,133
3590,A Site,Surreal,0,0,0,26,0,26,CT,133
3591,A Site,Surreal,0,0,0,0,0,0,T,133
3592,Lane Side,FalleN,1,2,-1,100,147,-47,CT,85
3593,Lane Side,FalleN,2,1,1,260,176,84,T,85
3594,Arch Side,FalleN,0,2,-2,92,229,-137,CT,85
3595,Arch Side,FalleN,1,1,0,100,149,-49,T,85
3596,CT Banana Half Wall Side,FalleN,1,0,1,98,19,79,CT,85
3597,CT Banana Half Wall Side,FalleN,1,2,-1,100,200,-100,T,85
3598,Top Mid Lane Side ,FalleN,0,2,-2,270,151,119,CT,85
3599,Top Mid Lane Side ,FalleN,0,2,-2,0,200,-200,T,85
3600,Top Mid Arch Side,FalleN,1,0,1,100,0,100,CT,85
3601,Top Mid Arch Side,FalleN,0,0,0,28,43,-15,T,85
3602,B Site,FalleN,0,1,-1,0,100,-100,CT,85
3603,B Site,FalleN,0,2,-2,53,132,-79,T,85
3604,Banana,FalleN,1,0,1,56,35,21,CT,85
3605,Banana,FalleN,1,0,1,108,224,-116,T,85
3606,2nd Oranges,FalleN,0,1,-1,0,100,-100,CT,85
3607,2nd Oranges,FalleN,1,1,0,69,100,-31,T,85
3608,CT Arch,FalleN,4,3,1,366,297,69,CT,85
3609,CT Arch,FalleN,1,0,1,73,0,73,T,85
3610,Behind Coffins Playing the B Site Cross,FalleN,3,1,2,109,157,-48,CT,85
3611,Behind Coffins Playing the B Site Cross,FalleN,1,2,-1,100,68,32,T,85
3612,Chokepoint Entrance onto A site from Library Side,FalleN,4,0,4,353,0,353,CT,85
3613,Chokepoint Entrance onto A site from Library Side,FalleN,0,0,0,0,0,0,T,85
3614,Logs,FalleN,1,0,1,23,0,23,CT,85
3615,Logs,FalleN,1,2,-1,170,168,2,T,85
3616,Top Mid Chokepoint,FalleN,0,0,0,0,49,-49,CT,85
3617,Top Mid Chokepoint,FalleN,4,1,3,319,168,151,T,85
3618,CT Outside Construction,FalleN,0,1,-1,9,100,-91,CT,85
3619,CT Outside Construction,FalleN,0,1,-1,0,100,-100,T,85
3620,Top Balcony ,FalleN,0,0,0,0,0,0,CT,85
3621,Top Balcony ,FalleN,0,2,-2,50,132,-82,T,85
3622,Lane Peek Towards Top Mid,FalleN,0,1,-1,0,100,-100,CT,85
3623,Lane Peek Towards Top Mid,FalleN,1,2,-1,124,153,-29,T,85
3624,CT Peek Towards B Choke,FalleN,2,1,1,230,100,130,CT,85
3625,CT Peek Towards B Choke,FalleN,1,0,1,40,0,40,T,85
3626,A Site Behind Middle Boxes/Pillar hidden from Lane,FalleN,0,0,0,0,0,0,CT,85
3627,A Site Behind Middle Boxes/Pillar hidden from Lane,FalleN,0,2,-2,56,159,-103,T,85
3628,Top Hay Bales,FalleN,0,0,0,0,0,0,CT,85
3629,Top Hay Bales,FalleN,0,2,-2,0,120,-120,T,85
3630,Construction,FalleN,2,1,1,266,100,166,CT,85
3631,Construction,FalleN,0,0,0,0,0,0,T,85
3632,Lane Patio,FalleN,0,0,0,0,0,0,CT,85
3633,Lane Patio,FalleN,0,0,0,0,0,0,T,85
3634,CT Banana Barrels,FalleN,0,1,-1,0,100,-100,CT,85
3635,CT Banana Barrels,FalleN,0,1,-1,81,89,-8,T,85
3636,CT Banana Sandbangs,FalleN,0,1,-1,0,100,-100,CT,85
3637,CT Banana Sandbangs,FalleN,0,0,0,0,0,0,T,85
3638,1st Oranges,FalleN,0,0,0,0,0,0,CT,85
3639,1st Oranges,FalleN,0,0,0,0,0,0,T,85
3640,Pit Below Balcony,FalleN,0,0,0,0,0,0,CT,85
3641,Pit Below Balcony,FalleN,0,0,0,0,0,0,T,85
3642,CT Boost,FalleN,0,0,0,16,0,16,CT,85
3643,CT Boost,FalleN,0,0,0,0,0,0,T,85
3644,Arch Side CT Corner Peeking Towards Top Mid,FalleN,0,0,0,0,0,0,CT,85
3645,Arch Side CT Corner Peeking Towards Top Mid,FalleN,0,1,-1,0,100,-100,T,85
3646,Boiler Peek to Mid,FalleN,0,0,0,0,0,0,CT,85
3647,Boiler Peek to Mid,FalleN,0,1,-1,22,100,-78,T,85
3648,Quad Box,FalleN,0,1,-1,0,76,-76,CT,85
3649,Quad Box,FalleN,0,0,0,0,0,0,T,85
3650,Outside Library,FalleN,2,0,2,270,0,270,CT,85
3651,Outside Library,FalleN,0,0,0,0,0,0,T,85
3652,Chokepoint Entering B,FalleN,2,1,1,177,106,71,CT,85
3653,Chokepoint Entering B,FalleN,4,0,4,322,28,294,T,85
3654,CT Outside Kitchen,FalleN,0,0,0,0,0,0,CT,85
3655,CT Outside Kitchen,FalleN,0,0,0,0,0,0,T,85
3656,Boiler Room,FalleN,0,0,0,0,0,0,CT,85
3657,Boiler Room,FalleN,0,0,0,0,0,0,T,85
3658,Back Alley,FalleN,0,0,0,0,0,0,CT,85
3659,Back Alley,FalleN,0,1,-1,0,100,-100,T,85
3660,Lane Behind Pillar,FalleN,0,0,0,0,0,0,CT,85
3661,Lane Behind Pillar,FalleN,0,0,0,0,0,0,T,85
3662,CT Banana Sandbags Right Corner,FalleN,0,0,0,0,1,-1,CT,85
3663,CT Banana Sandbags Right Corner,FalleN,0,0,0,0,0,0,T,85
3664,Front Coffins,FalleN,0,0,0,0,0,0,CT,85
3665,Front Coffins,FalleN,0,0,0,0,0,0,T,85
3666,A Site Behind Default Boxes,FalleN,0,0,0,0,0,0,CT,85
3667,A Site Behind Default Boxes,FalleN,0,1,-1,97,100,-3,T,85
3668,Boiler Side Stairs,FalleN,1,1,0,89,100,-11,CT,85
3669,Boiler Side Stairs,FalleN,0,0,0,0,0,0,T,85
3670,Top Coffins,FalleN,0,0,0,66,15,51,CT,85
3671,Top Coffins,FalleN,0,0,0,0,0,0,T,85
3672,Graveyard Stairs,FalleN,0,0,0,0,0,0,CT,85
3673,Graveyard Stairs,FalleN,0,0,0,95,0,95,T,85
3674,Lane Side,Twistzz,0,0,0,41,0,41,CT,74
3675,Lane Side,Twistzz,3,2,1,270,226,44,T,74
3676,Top Balcony ,Twistzz,1,0,1,168,0,168,CT,74
3677,Top Balcony ,Twistzz,1,3,-2,217,289,-72,T,74
3678,Top Mid Lane Side ,Twistzz,0,0,0,19,3,16,CT,74
3679,Top Mid Lane Side ,Twistzz,4,2,2,452,325,127,T,74
3680,Top Mid Arch Side,Twistzz,0,0,0,59,150,-91,CT,74
3681,Top Mid Arch Side,Twistzz,2,2,0,131,101,30,T,74
3682,Behind Coffins Playing the B Site Cross,Twistzz,1,1,0,39,100,-61,CT,74
3683,Behind Coffins Playing the B Site Cross,Twistzz,0,1,-1,0,44,-44,T,74
3684,A Bombsite Back Site,Twistzz,0,0,0,0,0,0,CT,74
3685,A Bombsite Back Site,Twistzz,1,1,0,26,75,-49,T,74
3686,1st Oranges,Twistzz,0,0,0,0,0,0,CT,74
3687,1st Oranges,Twistzz,1,0,1,100,0,100,T,74
3688,Middle,Twistzz,0,1,-1,0,100,-100,CT,74
3689,Middle,Twistzz,1,0,1,172,22,150,T,74
3690,A Site,Twistzz,1,2,-1,144,287,-143,CT,74
3691,A Site,Twistzz,0,0,0,0,0,0,T,74
3692,Apartments,Twistzz,0,0,0,0,0,0,CT,74
3693,Apartments,Twistzz,0,1,-1,12,100,-88,T,74
3694,Top Mid Chokepoint,Twistzz,0,0,0,39,0,39,CT,74
3695,Top Mid Chokepoint,Twistzz,0,1,-1,30,199,-169,T,74
3696,Arch Side,Twistzz,1,1,0,223,107,116,CT,74
3697,Arch Side,Twistzz,1,0,1,50,59,-9,T,74
3698,Boiler Side Stairs,Twistzz,2,0,2,121,0,121,CT,74
3699,Boiler Side Stairs,Twistzz,0,0,0,27,0,27,T,74
3700,A Bombsite Close Left,Twistzz,0,1,-1,40,100,-60,CT,74
3701,A Bombsite Close Left,Twistzz,0,0,0,0,9,-9,T,74
3702,CT Spawn ,Twistzz,0,0,0,0,0,0,CT,74
3703,CT Spawn ,Twistzz,0,0,0,0,0,0,T,74
3704,CT Outside Construction,Twistzz,0,0,0,0,0,0,CT,74
3705,CT Outside Construction,Twistzz,0,1,-1,0,63,-63,T,74
3706,Pit,Twistzz,0,1,-1,97,100,-3,CT,74
3707,Pit,Twistzz,0,1,-1,0,100,-100,T,74
3708,B Site,Twistzz,0,0,0,0,0,0,CT,74
3709,B Site,Twistzz,0,1,-1,24,88,-64,T,74
3710,Arch Side Cubby,Twistzz,0,1,-1,31,100,-69,CT,74
3711,Arch Side Cubby,Twistzz,1,0,1,34,0,34,T,74
3712,Pit Peek Towards Lane,Twistzz,0,0,0,0,0,0,CT,74
3713,Pit Peek Towards Lane,Twistzz,0,1,-1,5,100,-95,T,74
3714,Deep Apps Past Hallway,Twistzz,0,0,0,0,0,0,CT,74
3715,Deep Apps Past Hallway,Twistzz,0,0,0,0,0,0,T,74
3716,Lane Patio,Twistzz,3,0,3,328,27,301,CT,74
3717,Lane Patio,Twistzz,0,0,0,0,0,0,T,74
3718,Boiler Peek to Mid,Twistzz,0,0,0,0,3,-3,CT,74
3719,Boiler Peek to Mid,Twistzz,2,0,2,153,50,103,T,74
3720,Lane Behind Pillar,Twistzz,1,0,1,100,38,62,CT,74
3721,Lane Behind Pillar,Twistzz,0,0,0,54,0,54,T,74
3722,A Site Right Side Middle Pillar,Twistzz,1,0,1,9,0,9,CT,74
3723,A Site Right Side Middle Pillar,Twistzz,0,0,0,0,0,0,T,74
3724,Apartments Hallway Peek from T Side,Twistzz,0,0,0,0,0,0,CT,74
3725,Apartments Hallway Peek from T Side,Twistzz,0,0,0,0,0,0,T,74
3726,Default Plant A Site,Twistzz,0,0,0,0,0,0,CT,74
3727,Default Plant A Site,Twistzz,0,0,0,0,0,0,T,74
3728,Top Hay Bales,Twistzz,0,0,0,0,0,0,CT,74
3729,Top Hay Bales,Twistzz,1,1,0,95,100,-5,T,74
3730,B Site Cross for T's Exposed to CT and Quad,Twistzz,0,0,0,0,0,0,CT,74
3731,B Site Cross for T's Exposed to CT and Quad,Twistzz,0,0,0,0,0,0,T,74
3732,CT Peek Towards B Choke,Twistzz,0,0,0,0,0,0,CT,74
3733,CT Peek Towards B Choke,Twistzz,0,1,-1,0,100,-100,T,74
3734,Library,Twistzz,0,0,0,0,0,0,CT,74
3735,Library,Twistzz,0,0,0,0,0,0,T,74
3736,Boiler Room,Twistzz,0,0,0,0,0,0,CT,74
3737,Boiler Room,Twistzz,0,0,0,0,0,0,T,74
3738,Bottom Graveyard,Twistzz,1,1,0,100,47,53,CT,74
3739,Bottom Graveyard,Twistzz,1,0,1,73,0,73,T,74
3740,Outside Library,Twistzz,2,0,2,172,0,172,CT,74
3741,Outside Library,Twistzz,1,1,0,40,100,-60,T,74
3742,T Apps,Twistzz,0,0,0,0,0,0,CT,74
3743,T Apps,Twistzz,0,0,0,0,0,0,T,74
3744,Grill,Twistzz,0,1,-1,91,47,44,CT,74
3745,Grill,Twistzz,0,0,0,0,0,0,T,74
3746,CT Boost,Twistzz,0,1,-1,0,20,-20,CT,74
3747,CT Boost,Twistzz,0,0,0,0,0,0,T,74
3748,Chokepoint Entering B,Twistzz,0,0,0,0,0,0,CT,74
3749,Chokepoint Entering B,Twistzz,2,1,1,179,166,13,T,74
3750,Graveyard Stairs,Twistzz,0,1,-1,0,83,-83,CT,74
3751,Graveyard Stairs,Twistzz,0,0,0,0,0,0,T,74
3752,Pit Below Balcony,Twistzz,5,0,5,613,52,561,CT,74
3753,Pit Below Balcony,Twistzz,0,0,0,0,0,0,T,74
3754,Apps T Side Stairs,Twistzz,0,1,-1,66,100,-34,CT,74
3755,Apps T Side Stairs,Twistzz,1,0,1,100,57,43,T,74
3756,SecondMid,Twistzz,0,0,0,0,0,0,CT,74
3757,SecondMid,Twistzz,2,1,1,452,144,308,T,74
3758,TopofMid,Twistzz,0,0,0,0,0,0,CT,74
3759,TopofMid,Twistzz,0,0,0,0,0,0,T,74
3760,A Site Behind Middle Boxes/Pillar hidden from Lane,Twistzz,0,0,0,61,0,61,CT,74
3761,A Site Behind Middle Boxes/Pillar hidden from Lane,Twistzz,1,0,1,71,16,55,T,74
3762,Front Coffins,Twistzz,0,0,0,0,53,-53,CT,74
3763,Front Coffins,Twistzz,0,1,-1,27,76,-49,T,74
3764,CT Banana Half Wall Side,Twistzz,0,1,-1,38,100,-62,CT,74
3765,CT Banana Half Wall Side,Twistzz,0,0,0,27,48,-21,T,74
3766,Top Coffins,Twistzz,0,0,0,42,0,42,CT,74
3767,Top Coffins,Twistzz,1,0,1,67,0,67,T,74
3768,Arch Side CT Corner Peeking Towards Top Mid,Twistzz,0,0,0,0,0,0,CT,74
3769,Arch Side CT Corner Peeking Towards Top Mid,Twistzz,0,0,0,0,0,0,T,74
3770,CT Speed Way,Twistzz,0,0,0,0,0,0,CT,74
3771,CT Speed Way,Twistzz,0,0,0,0,0,0,T,74
3772,Top Mid Arch Side,MiGHTYMAX,1,3,-2,279,300,-21,CT,133
3773,Top Mid Arch Side,MiGHTYMAX,0,5,-5,53,500,-447,T,133
3774,Chokepoint Entering B,MiGHTYMAX,1,2,-1,257,249,8,CT,133
3775,Chokepoint Entering B,MiGHTYMAX,5,5,0,495,607,-112,T,133
3776,Banana,MiGHTYMAX,1,0,1,64,50,14,CT,133
3777,Banana,MiGHTYMAX,4,5,-1,668,910,-242,T,133
3778,CT Banana Half Wall Side,MiGHTYMAX,2,1,1,255,211,44,CT,133
3779,CT Banana Half Wall Side,MiGHTYMAX,4,2,2,352,60,292,T,133
3780,CT Peek Towards B Choke,MiGHTYMAX,0,4,-4,22,385,-363,CT,133
3781,CT Peek Towards B Choke,MiGHTYMAX,1,0,1,189,4,185,T,133
3782,Arch Side,MiGHTYMAX,2,3,-1,290,273,17,CT,133
3783,Arch Side,MiGHTYMAX,0,3,-3,0,298,-298,T,133
3784,Top Mid Lane Side ,MiGHTYMAX,2,2,0,183,113,70,CT,133
3785,Top Mid Lane Side ,MiGHTYMAX,0,1,-1,23,146,-123,T,133
3786,Lane Side,MiGHTYMAX,1,0,1,47,0,47,CT,133
3787,Lane Side,MiGHTYMAX,0,3,-3,142,234,-92,T,133
3788,Grill,MiGHTYMAX,0,0,0,0,0,0,CT,133
3789,Grill,MiGHTYMAX,1,4,-3,11,366,-355,T,133
3790,Top Mid Chokepoint,MiGHTYMAX,0,2,-2,0,176,-176,CT,133
3791,Top Mid Chokepoint,MiGHTYMAX,3,2,1,349,218,131,T,133
3792,B Site,MiGHTYMAX,1,1,0,120,115,5,CT,133
3793,B Site,MiGHTYMAX,0,2,-2,27,143,-116,T,133
3794,Behind Coffins Playing the B Site Cross,MiGHTYMAX,1,2,-1,39,196,-157,CT,133
3795,Behind Coffins Playing the B Site Cross,MiGHTYMAX,0,0,0,0,0,0,T,133
3796,T Ramp Peeking Towards Mid,MiGHTYMAX,0,0,0,0,0,0,CT,133
3797,T Ramp Peeking Towards Mid,MiGHTYMAX,2,4,-2,458,343,115,T,133
3798,1st Oranges,MiGHTYMAX,0,0,0,0,0,0,CT,133
3799,1st Oranges,MiGHTYMAX,1,1,0,68,86,-18,T,133
3800,B Site Cross for T's Exposed to CT and Quad,MiGHTYMAX,0,0,0,35,0,35,CT,133
3801,B Site Cross for T's Exposed to CT and Quad,MiGHTYMAX,1,1,0,171,135,36,T,133
3802,Logs,MiGHTYMAX,1,2,-1,141,139,2,CT,133
3803,Logs,MiGHTYMAX,0,1,-1,69,42,27,T,133
3804,Bottom Mid exposed to Top Mid,MiGHTYMAX,1,2,-1,191,159,32,CT,133
3805,Bottom Mid exposed to Top Mid,MiGHTYMAX,1,1,0,0,50,-50,T,133
3806,Front Coffins,MiGHTYMAX,0,0,0,0,0,0,CT,133
3807,Front Coffins,MiGHTYMAX,1,2,-1,73,200,-127,T,133
3808,Dark,MiGHTYMAX,0,1,-1,0,100,-100,CT,133
3809,Dark,MiGHTYMAX,0,1,-1,26,82,-56,T,133
3810,Top Balcony ,MiGHTYMAX,0,1,-1,38,100,-62,CT,133
3811,Top Balcony ,MiGHTYMAX,0,0,0,0,0,0,T,133
3812,A Site,MiGHTYMAX,0,1,-1,83,100,-17,CT,133
3813,A Site,MiGHTYMAX,0,0,0,0,16,-16,T,133
3814,Next to Library Cubby,MiGHTYMAX,0,2,-2,116,191,-75,CT,133
3815,Next to Library Cubby,MiGHTYMAX,0,0,0,0,0,0,T,133
3816,CT Banana Barrels,MiGHTYMAX,0,0,0,0,0,0,CT,133
3817,CT Banana Barrels,MiGHTYMAX,0,1,-1,39,100,-61,T,133
3818,2nd Oranges,MiGHTYMAX,0,0,0,0,0,0,CT,133
3819,2nd Oranges,MiGHTYMAX,2,0,2,160,21,139,T,133
3820,Chokepoint Entrance onto A site from Library Side,MiGHTYMAX,1,1,0,81,154,-73,CT,133
3821,Chokepoint Entrance onto A site from Library Side,MiGHTYMAX,0,1,-1,80,100,-20,T,133
3822,CT Tree,MiGHTYMAX,0,0,0,0,0,0,CT,133
3823,CT Tree,MiGHTYMAX,0,1,-1,0,96,-96,T,133
3824,A Site Behind Middle Boxes/Pillar hidden from Lane,MiGHTYMAX,0,0,0,0,0,0,CT,133
3825,A Site Behind Middle Boxes/Pillar hidden from Lane,MiGHTYMAX,0,1,-1,33,140,-107,T,133
3826,A Bombsite Close Left,MiGHTYMAX,1,1,0,18,92,-74,CT,133
3827,A Bombsite Close Left,MiGHTYMAX,0,1,-1,81,81,0,T,133
3828,Middle,MiGHTYMAX,0,0,0,0,0,0,CT,133
3829,Middle,MiGHTYMAX,0,0,0,2,35,-33,T,133
3830,CT Outside Arch,MiGHTYMAX,1,1,0,56,100,-44,CT,133
3831,CT Outside Arch,MiGHTYMAX,0,0,0,0,0,0,T,133
3832,Fountain,MiGHTYMAX,0,0,0,0,0,0,CT,133
3833,Fountain,MiGHTYMAX,2,1,1,194,146,48,T,133
3834,Apps Hallway,MiGHTYMAX,0,0,0,0,0,0,CT,133
3835,Apps Hallway,MiGHTYMAX,0,0,0,0,0,0,T,133
3836,Arch Side Cubby,MiGHTYMAX,0,1,-1,110,142,-32,CT,133
3837,Arch Side Cubby,MiGHTYMAX,0,0,0,0,0,0,T,133
3838,Construction,MiGHTYMAX,0,1,-1,15,100,-85,CT,133
3839,Construction,MiGHTYMAX,0,0,0,46,0,46,T,133
3840,Apps T Side Stairs,MiGHTYMAX,0,0,0,0,0,0,CT,133
3841,Apps T Side Stairs,MiGHTYMAX,0,0,0,16,0,16,T,133
3842,Outside Library,MiGHTYMAX,1,1,0,99,100,-1,CT,133
3843,Outside Library,MiGHTYMAX,0,0,0,0,0,0,T,133
3844,TopofMid,MiGHTYMAX,0,0,0,0,0,0,CT,133
3845,TopofMid,MiGHTYMAX,0,0,0,0,0,0,T,133
3846,CT Banana Sandbangs,MiGHTYMAX,0,0,0,49,27,22,CT,133
3847,CT Banana Sandbangs,MiGHTYMAX,0,0,0,61,86,-25,T,133
3848,Pit Peek Towards Lane,MiGHTYMAX,1,1,0,100,100,0,CT,133
3849,Pit Peek Towards Lane,MiGHTYMAX,0,0,0,0,0,0,T,133
3850,CT Banana Close Left Half Wall,MiGHTYMAX,1,0,1,100,106,-6,CT,133
3851,CT Banana Close Left Half Wall,MiGHTYMAX,0,0,0,27,6,21,T,133
3852,Right Side Quadbox Peek for a CT,MiGHTYMAX,1,0,1,57,0,57,CT,133
3853,Right Side Quadbox Peek for a CT,MiGHTYMAX,0,1,-1,24,11,13,T,133
3854,A Site Behind Default Boxes,MiGHTYMAX,0,1,-1,0,58,-58,CT,133
3855,A Site Behind Default Boxes,MiGHTYMAX,0,0,0,0,0,0,T,133
3856,BombsiteB,MiGHTYMAX,0,0,0,0,0,0,CT,133
3857,BombsiteB,MiGHTYMAX,0,1,-1,0,8,-8,T,133
3858,Quad Box,MiGHTYMAX,0,0,0,16,0,16,CT,133
3859,Quad Box,MiGHTYMAX,0,0,0,0,0,0,T,133
3860,Bottom Mid Banana,MiGHTYMAX,0,0,0,0,0,0,CT,133
3861,Bottom Mid Banana,MiGHTYMAX,0,1,-1,23,140,-117,T,133
3862,Banana,arT,2,0,2,133,56,77,CT,80
3863,Banana,arT,0,1,-1,203,282,-79,T,80
3864,Chokepoint Entering B,arT,4,1,3,391,324,67,CT,80
3865,Chokepoint Entering B,arT,2,1,1,117,200,-83,T,80
3866,CT Banana Half Wall Side,arT,0,2,-2,14,217,-203,CT,80
3867,CT Banana Half Wall Side,arT,4,6,-2,721,567,154,T,80
3868,CT Banana Sandbangs,arT,2,1,1,265,238,27,CT,80
3869,CT Banana Sandbangs,arT,0,1,-1,9,155,-146,T,80
3870,Top Mid Lane Side ,arT,0,0,0,0,0,0,CT,80
3871,Top Mid Lane Side ,arT,0,2,-2,94,131,-37,T,80
3872,Arch Side,arT,2,0,2,91,0,91,CT,80
3873,Arch Side,arT,1,1,0,100,188,-88,T,80
3874,Top Mid Arch Side,arT,2,0,2,110,82,28,CT,80
3875,Top Mid Arch Side,arT,2,3,-1,133,198,-65,T,80
3876,CT Peek Towards B Choke,arT,3,1,2,268,96,172,CT,80
3877,CT Peek Towards B Choke,arT,2,1,1,297,100,197,T,80
3878,CT Arch,arT,3,0,3,295,28,267,CT,80
3879,CT Arch,arT,0,1,-1,0,55,-55,T,80
3880,Library,arT,0,0,0,33,24,9,CT,80
3881,Library,arT,1,1,0,100,102,-2,T,80
3882,1st Oranges,arT,1,0,1,9,0,9,CT,80
3883,1st Oranges,arT,0,1,-1,0,81,-81,T,80
3884,A Site,arT,0,1,-1,15,100,-85,CT,80
3885,A Site,arT,0,1,-1,0,100,-100,T,80
3886,Construction,arT,1,0,1,149,69,80,CT,80
3887,Construction,arT,1,0,1,100,49,51,T,80
3888,B Site,arT,1,0,1,60,0,60,CT,80
3889,B Site,arT,0,1,-1,0,100,-100,T,80
3890,Top Mid Chokepoint,arT,0,0,0,0,0,0,CT,80
3891,Top Mid Chokepoint,arT,1,1,0,152,129,23,T,80
3892,Left Side Quadbox Peek for a CT,arT,0,0,0,0,0,0,CT,80
3893,Left Side Quadbox Peek for a CT,arT,0,0,0,0,0,0,T,80
3894,Pit,arT,0,0,0,0,0,0,CT,80
3895,Pit,arT,0,0,0,0,0,0,T,80
3896,2nd Oranges,arT,0,2,-2,112,172,-60,CT,80
3897,2nd Oranges,arT,0,0,0,0,0,0,T,80
3898,CT Banana Barrels,arT,0,1,-1,54,100,-46,CT,80
3899,CT Banana Barrels,arT,0,1,-1,0,127,-127,T,80
3900,CT Banana Sandbags Right Corner,arT,2,1,1,176,6,170,CT,80
3901,CT Banana Sandbags Right Corner,arT,0,1,-1,0,62,-62,T,80
3902,A Bombsite Back Site,arT,0,0,0,0,0,0,CT,80
3903,A Bombsite Back Site,arT,1,2,-1,100,104,-4,T,80
3904,Pit Peek Towards Lane,arT,0,1,-1,70,100,-30,CT,80
3905,Pit Peek Towards Lane,arT,0,0,0,0,0,0,T,80
3906,CT Boost,arT,0,0,0,0,0,0,CT,80
3907,CT Boost,arT,0,0,0,0,0,0,T,80
3908,Deep CT Peeking Towards B Site,arT,0,0,0,0,0,0,CT,80
3909,Deep CT Peeking Towards B Site,arT,1,0,1,126,0,126,T,80
3910,Lane Side,arT,0,0,0,0,0,0,CT,80
3911,Lane Side,arT,1,1,0,144,225,-81,T,80
3912,Grill,arT,0,0,0,0,0,0,CT,80
3913,Grill,arT,0,1,-1,0,100,-100,T,80
3914,Underpass,arT,0,0,0,0,0,0,CT,80
3915,Underpass,arT,0,1,-1,46,70,-24,T,80
3916,Top Balcony ,arT,0,0,0,0,0,0,CT,80
3917,Top Balcony ,arT,1,0,1,100,22,78,T,80
3918,CT Spawn ,arT,0,0,0,0,0,0,CT,80
3919,CT Spawn ,arT,0,1,-1,0,100,-100,T,80
3920,Middle,arT,0,0,0,0,0,0,CT,80
3921,Middle,arT,0,0,0,7,84,-77,T,80
3922,A Site Right Side Middle Pillar,arT,0,0,0,0,0,0,CT,80
3923,A Site Right Side Middle Pillar,arT,1,0,1,100,72,28,T,80
3924,Lane Patio,arT,0,0,0,0,0,0,CT,80
3925,Lane Patio,arT,0,1,-1,0,96,-96,T,80
3926,SecondMid,arT,0,0,0,0,0,0,CT,80
3927,SecondMid,arT,0,0,0,9,0,9,T,80
3928,Behind B Site Back Pillar,arT,1,1,0,179,134,45,CT,80
3929,Behind B Site Back Pillar,arT,0,0,0,0,0,0,T,80
3930,Top Hay Bales,arT,0,0,0,0,0,0,CT,80
3931,Top Hay Bales,arT,0,0,0,0,0,0,T,80
3932,A Site Behind Middle Boxes/Pillar hidden from Lane,arT,0,0,0,0,0,0,CT,80
3933,A Site Behind Middle Boxes/Pillar hidden from Lane,arT,0,0,0,0,0,0,T,80
3934,CT Outside Kitchen,arT,0,0,0,0,0,0,CT,80
3935,CT Outside Kitchen,arT,1,1,0,154,100,54,T,80
3936,Banana,Stewie2K,1,3,-2,326,300,26,CT,85
3937,Banana,Stewie2K,3,4,-1,410,757,-347,T,85
3938,Chokepoint Entering B,Stewie2K,1,1,0,353,115,238,CT,85
3939,Chokepoint Entering B,Stewie2K,1,1,0,29,116,-87,T,85
3940,CT Banana Half Wall Side,Stewie2K,1,0,1,205,64,141,CT,85
3941,CT Banana Half Wall Side,Stewie2K,2,2,0,90,149,-59,T,85
3942,CT Peek Towards B Choke,Stewie2K,2,3,-1,296,343,-47,CT,85
3943,CT Peek Towards B Choke,Stewie2K,0,2,-2,0,174,-174,T,85
3944,CT Banana Sandbangs,Stewie2K,4,4,0,575,451,124,CT,85
3945,CT Banana Sandbangs,Stewie2K,0,0,0,0,0,0,T,85
3946,B Site,Stewie2K,1,2,-1,144,156,-12,CT,85
3947,B Site,Stewie2K,0,1,-1,0,58,-58,T,85
3948,Top Mid Lane Side ,Stewie2K,0,1,-1,66,100,-34,CT,85
3949,Top Mid Lane Side ,Stewie2K,0,1,-1,59,94,-35,T,85
3950,Top Mid Arch Side,Stewie2K,1,2,-1,98,196,-98,CT,85
3951,Top Mid Arch Side,Stewie2K,1,2,-1,72,165,-93,T,85
3952,Top Mid Chokepoint,Stewie2K,1,1,0,100,181,-81,CT,85
3953,Top Mid Chokepoint,Stewie2K,3,1,2,193,135,58,T,85
3954,Bottom Mid exposed to Top Mid,Stewie2K,1,0,1,100,0,100,CT,85
3955,Bottom Mid exposed to Top Mid,Stewie2K,0,0,0,0,31,-31,T,85
3956,Front Coffins,Stewie2K,0,0,0,0,0,0,CT,85
3957,Front Coffins,Stewie2K,0,0,0,0,0,0,T,85
3958,Deep CT Peeking Towards B Site,Stewie2K,0,2,-2,74,215,-141,CT,85
3959,Deep CT Peeking Towards B Site,Stewie2K,0,0,0,0,0,0,T,85
3960,Arch Side,Stewie2K,0,0,0,0,0,0,CT,85
3961,Arch Side,Stewie2K,2,0,2,210,89,121,T,85
3962,Top Balcony ,Stewie2K,0,0,0,0,0,0,CT,85
3963,Top Balcony ,Stewie2K,0,0,0,0,46,-46,T,85
3964,Left Side Quadbox Peek for a CT,Stewie2K,0,1,-1,0,12,-12,CT,85
3965,Left Side Quadbox Peek for a CT,Stewie2K,0,0,0,0,0,0,T,85
3966,B Site Cross for T's Exposed to CT and Quad,Stewie2K,2,2,0,207,332,-125,CT,85
3967,B Site Cross for T's Exposed to CT and Quad,Stewie2K,0,0,0,0,0,0,T,85
3968,Grill,Stewie2K,1,1,0,116,100,16,CT,85
3969,Grill,Stewie2K,0,1,-1,61,3,58,T,85
3970,Behind Coffins Playing the B Site Cross,Stewie2K,3,1,2,175,70,105,CT,85
3971,Behind Coffins Playing the B Site Cross,Stewie2K,0,0,0,0,0,0,T,85
3972,Library,Stewie2K,0,0,0,0,84,-84,CT,85
3973,Library,Stewie2K,0,1,-1,23,99,-76,T,85
3974,A Site Behind Default Boxes,Stewie2K,0,0,0,0,0,0,CT,85
3975,A Site Behind Default Boxes,Stewie2K,0,0,0,0,0,0,T,85
3976,T Ramp Peeking Towards Mid,Stewie2K,0,0,0,0,0,0,CT,85
3977,T Ramp Peeking Towards Mid,Stewie2K,1,2,-1,107,219,-112,T,85
3978,A Site,Stewie2K,0,0,0,0,0,0,CT,85
3979,A Site,Stewie2K,0,2,-2,54,128,-74,T,85
3980,CT Arch,Stewie2K,0,0,0,22,0,22,CT,85
3981,CT Arch,Stewie2K,0,1,-1,0,100,-100,T,85
3982,A Site Behind Middle Boxes/Pillar hidden from Lane,Stewie2K,1,1,0,96,16,80,CT,85
3983,A Site Behind Middle Boxes/Pillar hidden from Lane,Stewie2K,0,0,0,0,0,0,T,85
3984,Fountain,Stewie2K,0,1,-1,27,145,-118,CT,85
3985,Fountain,Stewie2K,0,0,0,0,0,0,T,85
3986,Arch Side CT Corner Peeking Towards Top Mid,Stewie2K,0,0,0,0,4,-4,CT,85
3987,Arch Side CT Corner Peeking Towards Top Mid,Stewie2K,0,1,-1,0,76,-76,T,85
3988,Deep Apps Past Hallway,Stewie2K,0,0,0,0,0,0,CT,85
3989,Deep Apps Past Hallway,Stewie2K,0,0,0,0,0,0,T,85
3990,Lane Behind Pillar,Stewie2K,0,0,0,0,0,0,CT,85
3991,Lane Behind Pillar,Stewie2K,0,0,0,0,0,0,T,85
3992,Outside Library,Stewie2K,0,0,0,0,0,0,CT,85
3993,Outside Library,Stewie2K,1,1,0,100,100,0,T,85
3994,Next to Library Cubby,Stewie2K,0,0,0,0,0,0,CT,85
3995,Next to Library Cubby,Stewie2K,0,0,0,0,0,0,T,85
3996,Dark,Stewie2K,3,0,3,235,27,208,CT,85
3997,Dark,Stewie2K,0,0,0,0,0,0,T,85
3998,1st Oranges,Stewie2K,2,0,2,113,37,76,CT,85
3999,1st Oranges,Stewie2K,0,0,0,0,0,0,T,85
4000,CT Boost,Stewie2K,2,0,2,182,63,119,CT,85
4001,CT Boost,Stewie2K,0,0,0,0,0,0,T,85
4002,Chokepoint Entrance onto A site from Library Side,Stewie2K,1,0,1,56,0,56,CT,85
4003,Chokepoint Entrance onto A site from Library Side,Stewie2K,2,1,1,111,100,11,T,85
4004,Pit Below Balcony,Stewie2K,0,0,0,0,0,0,CT,85
4005,Pit Below Balcony,Stewie2K,0,0,0,0,0,0,T,85
4006,Top Hay Bales,Stewie2K,0,0,0,0,0,0,CT,85
4007,Top Hay Bales,Stewie2K,0,1,-1,0,10,-10,T,85
4008,SecondMid,Stewie2K,1,0,1,87,0,87,CT,85
4009,SecondMid,Stewie2K,0,0,0,0,0,0,T,85
4010,Boiler Side Stairs,Stewie2K,0,0,0,0,0,0,CT,85
4011,Boiler Side Stairs,Stewie2K,0,0,0,0,0,0,T,85
4012,Logs,Stewie2K,1,0,1,100,0,100,CT,85
4013,Logs,Stewie2K,1,1,0,208,94,114,T,85
4014,Bottom Mid Banana,Stewie2K,0,0,0,22,0,22,CT,85
4015,Bottom Mid Banana,Stewie2K,0,1,-1,124,148,-24,T,85
4016,Middle,Stewie2K,0,0,0,0,0,0,CT,85
4017,Middle,Stewie2K,2,1,1,210,53,157,T,85
4018,Underpass,Stewie2K,0,0,0,35,0,35,CT,85
4019,Underpass,Stewie2K,0,1,-1,0,56,-56,T,85
4020,CT Spawn ,Stewie2K,0,0,0,0,0,0,CT,85
4021,CT Spawn ,Stewie2K,0,1,-1,0,100,-100,T,85
4022,Lane Side,Stewie2K,0,1,-1,0,56,-56,CT,85
4023,Lane Side,Stewie2K,1,0,1,32,86,-54,T,85
4024,CT Banana Half Wall Side,VINI,2,2,0,377,357,20,CT,80
4025,CT Banana Half Wall Side,VINI,0,2,-2,226,295,-69,T,80
4026,Chokepoint Entering B,VINI,1,1,0,74,100,-26,CT,80
4027,Chokepoint Entering B,VINI,1,3,-2,140,334,-194,T,80
4028,Top Mid Lane Side ,VINI,0,0,0,0,0,0,CT,80
4029,Top Mid Lane Side ,VINI,2,3,-1,227,218,9,T,80
4030,Top Mid Arch Side,VINI,0,1,-1,22,100,-78,CT,80
4031,Top Mid Arch Side,VINI,1,1,0,102,101,1,T,80
4032,Banana,VINI,0,0,0,0,0,0,CT,80
4033,Banana,VINI,0,2,-2,179,396,-217,T,80
4034,B Site,VINI,1,2,-1,187,161,26,CT,80
4035,B Site,VINI,1,2,-1,75,36,39,T,80
4036,CT Banana Barrels,VINI,1,1,0,140,113,27,CT,80
4037,CT Banana Barrels,VINI,1,0,1,57,52,5,T,80
4038,CT Peek Towards B Choke,VINI,3,1,2,247,180,67,CT,80
4039,CT Peek Towards B Choke,VINI,0,1,-1,0,100,-100,T,80
4040,Behind Coffins Playing the B Site Cross,VINI,1,1,0,128,100,28,CT,80
4041,Behind Coffins Playing the B Site Cross,VINI,0,1,-1,0,57,-57,T,80
4042,Grill,VINI,0,0,0,0,0,0,CT,80
4043,Grill,VINI,0,2,-2,26,243,-217,T,80
4044,2nd Oranges,VINI,0,0,0,0,19,-19,CT,80
4045,2nd Oranges,VINI,1,0,1,50,88,-38,T,80
4046,CT Arch,VINI,0,1,-1,0,38,-38,CT,80
4047,CT Arch,VINI,0,0,0,0,0,0,T,80
4048,Arch Side,VINI,2,0,2,200,0,200,CT,80
4049,Arch Side,VINI,0,0,0,117,0,117,T,80
4050,Logs,VINI,0,0,0,0,0,0,CT,80
4051,Logs,VINI,0,0,0,17,57,-40,T,80
4052,CT Outside Kitchen,VINI,0,0,0,0,0,0,CT,80
4053,CT Outside Kitchen,VINI,0,1,-1,0,100,-100,T,80
4054,Arch Side Cubby,VINI,3,0,3,141,0,141,CT,80
4055,Arch Side Cubby,VINI,0,0,0,0,0,0,T,80
4056,Front Coffins,VINI,0,0,0,0,0,0,CT,80
4057,Front Coffins,VINI,0,1,-1,8,100,-92,T,80
4058,CT Banana Sandbangs,VINI,7,1,6,927,356,571,CT,80
4059,CT Banana Sandbangs,VINI,1,1,0,122,57,65,T,80
4060,Middle,VINI,0,1,-1,0,72,-72,CT,80
4061,Middle,VINI,1,0,1,100,99,1,T,80
4062,Pit,VINI,0,0,0,0,0,0,CT,80
4063,Pit,VINI,0,0,0,0,0,0,T,80
4064,Lane Side,VINI,0,0,0,0,0,0,CT,80
4065,Lane Side,VINI,0,1,-1,6,100,-94,T,80
4066,Top Balcony ,VINI,0,0,0,0,0,0,CT,80
4067,Top Balcony ,VINI,2,0,2,133,22,111,T,80
4068,Apps T Side Stairs,VINI,0,1,-1,0,26,-26,CT,80
4069,Apps T Side Stairs,VINI,0,1,-1,0,100,-100,T,80
4070,B Site Cross for T's Exposed to CT and Quad,VINI,1,0,1,9,11,-2,CT,80
4071,B Site Cross for T's Exposed to CT and Quad,VINI,0,1,-1,54,110,-56,T,80
4072,Lane Patio,VINI,0,0,0,0,0,0,CT,80
4073,Lane Patio,VINI,0,1,-1,0,99,-99,T,80
4074,A Bombsite Close Left,VINI,1,0,1,98,27,71,CT,80
4075,A Bombsite Close Left,VINI,0,1,-1,26,88,-62,T,80
4076,Default Plant A Site,VINI,0,0,0,0,0,0,CT,80
4077,Default Plant A Site,VINI,0,1,-1,26,94,-68,T,80
4078,Construction Sandbags,VINI,0,0,0,0,0,0,CT,80
4079,Construction Sandbags,VINI,0,0,0,0,0,0,T,80
4080,Dumpster,VINI,0,0,0,0,0,0,CT,80
4081,Dumpster,VINI,0,1,-1,0,83,-83,T,80
4082,Boiler Side Stairs,VINI,0,0,0,0,0,0,CT,80
4083,Boiler Side Stairs,VINI,0,1,-1,26,0,26,T,80
4084,Outside Library,VINI,0,0,0,0,0,0,CT,80
4085,Outside Library,VINI,0,0,0,0,0,0,T,80
4086,Boiler Room,VINI,0,0,0,0,0,0,CT,80
4087,Boiler Room,VINI,0,1,-1,3,100,-97,T,80
4088,Library,VINI,1,0,1,90,0,90,CT,80
4089,Library,VINI,0,1,-1,0,51,-51,T,80
4090,Bottom Mid exposed to Top Mid,VINI,0,0,0,0,0,0,CT,80
4091,Bottom Mid exposed to Top Mid,VINI,0,0,0,0,0,0,T,80
4092,Top Coffins,VINI,0,0,0,0,0,0,CT,80
4093,Top Coffins,VINI,0,0,0,36,43,-7,T,80
4094,CT Banana Sandbags Right Corner,VINI,1,1,0,183,116,67,CT,80
4095,CT Banana Sandbags Right Corner,VINI,0,0,0,0,12,-12,T,80
4096,Dark,VINI,3,0,3,170,0,170,CT,80
4097,Dark,VINI,1,0,1,100,85,15,T,80
4098,CT Boost,VINI,0,0,0,0,0,0,CT,80
4099,CT Boost,VINI,0,0,0,0,0,0,T,80
4100,A Bombsite Back Site,VINI,0,0,0,0,0,0,CT,80
4101,A Bombsite Back Site,VINI,0,0,0,0,0,0,T,80
4102,A Site,VINI,0,0,0,0,0,0,CT,80
4103,A Site,VINI,0,0,0,0,0,0,T,80
4104,Lane Side,Grim,1,1,0,113,100,13,CT,85
4105,Lane Side,Grim,1,2,-1,34,107,-73,T,85
4106,Deep Apps Past Hallway,Grim,5,1,4,267,116,151,CT,85
4107,Deep Apps Past Hallway,Grim,0,0,0,0,0,0,T,85
4108,Top Mid Lane Side ,Grim,0,0,0,19,0,19,CT,85
4109,Top Mid Lane Side ,Grim,1,5,-4,105,492,-387,T,85
4110,Top Balcony ,Grim,4,2,2,356,259,97,CT,85
4111,Top Balcony ,Grim,0,0,0,0,0,0,T,85
4112,Pit Below Balcony,Grim,3,3,0,331,333,-2,CT,85
4113,Pit Below Balcony,Grim,0,0,0,0,0,0,T,85
4114,Banana,Grim,0,0,0,0,0,0,CT,85
4115,Banana,Grim,1,3,-2,239,432,-193,T,85
4116,Boiler Side Stairs,Grim,0,0,0,0,0,0,CT,85
4117,Boiler Side Stairs,Grim,0,1,-1,0,41,-41,T,85
4118,A Bombsite Close Left,Grim,0,0,0,0,0,0,CT,85
4119,A Bombsite Close Left,Grim,1,1,0,113,100,13,T,85
4120,B Site,Grim,0,1,-1,0,101,-101,CT,85
4121,B Site,Grim,1,2,-1,71,63,8,T,85
4122,CT Peek Towards B Choke,Grim,2,3,-1,239,249,-10,CT,85
4123,CT Peek Towards B Choke,Grim,0,1,-1,81,98,-17,T,85
4124,CT Banana Half Wall Side,Grim,1,0,1,100,29,71,CT,85
4125,CT Banana Half Wall Side,Grim,2,1,1,200,100,100,T,85
4126,Pit Peek Towards Lane,Grim,7,3,4,598,479,119,CT,85
4127,Pit Peek Towards Lane,Grim,0,0,0,0,0,0,T,85
4128,Pit,Grim,4,2,2,311,159,152,CT,85
4129,Pit,Grim,1,1,0,121,78,43,T,85
4130,Outside Library,Grim,0,0,0,0,92,-92,CT,85
4131,Outside Library,Grim,0,0,0,0,0,0,T,85
4132,Library,Grim,0,2,-2,0,108,-108,CT,85
4133,Library,Grim,0,0,0,0,0,0,T,85
4134,Chokepoint Entering B,Grim,0,1,-1,0,100,-100,CT,85
4135,Chokepoint Entering B,Grim,0,2,-2,104,328,-224,T,85
4136,Middle,Grim,0,0,0,0,0,0,CT,85
4137,Middle,Grim,3,1,2,300,168,132,T,85
4138,Top Mid Chokepoint,Grim,0,1,-1,20,100,-80,CT,85
4139,Top Mid Chokepoint,Grim,1,1,0,121,135,-14,T,85
4140,Quad Box,Grim,1,1,0,100,70,30,CT,85
4141,Quad Box,Grim,0,0,0,0,0,0,T,85
4142,A Bombsite Back Site,Grim,0,0,0,0,0,0,CT,85
4143,A Bombsite Back Site,Grim,0,1,-1,0,100,-100,T,85
4144,2nd Oranges,Grim,0,0,0,0,0,0,CT,85
4145,2nd Oranges,Grim,2,2,0,176,127,49,T,85
4146,B Site Cross for T's Exposed to CT and Quad,Grim,0,0,0,0,0,0,CT,85
4147,B Site Cross for T's Exposed to CT and Quad,Grim,0,1,-1,0,37,-37,T,85
4148,Apps Hallway,Grim,1,0,1,73,54,19,CT,85
4149,Apps Hallway,Grim,0,0,0,0,0,0,T,85
4150,CT Banana Sandbangs,Grim,0,0,0,0,0,0,CT,85
4151,CT Banana Sandbangs,Grim,0,1,-1,39,15,24,T,85
4152,Dark,Grim,0,0,0,0,0,0,CT,85
4153,Dark,Grim,1,1,0,93,22,71,T,85
4154,A Site,Grim,0,0,0,0,0,0,CT,85
4155,A Site,Grim,0,1,-1,0,67,-67,T,85
4156,Apartments,Grim,0,0,0,0,0,0,CT,85
4157,Apartments,Grim,0,0,0,0,0,0,T,85
4158,Behind Coffins Playing the B Site Cross,Grim,0,0,0,0,0,0,CT,85
4159,Behind Coffins Playing the B Site Cross,Grim,0,0,0,0,0,0,T,85
4160,SecondMid,Grim,0,1,-1,68,100,-32,CT,85
4161,SecondMid,Grim,0,0,0,0,0,0,T,85
4162,Chokepoint Entrance onto A site from Library Side,Grim,0,0,0,0,0,0,CT,85
4163,Chokepoint Entrance onto A site from Library Side,Grim,0,0,0,0,0,0,T,85
4164,Grill,Grim,0,0,0,0,0,0,CT,85
4165,Grill,Grim,0,0,0,0,32,-32,T,85
4166,Lane Peek Towards Top Mid,Grim,0,0,0,0,24,-24,CT,85
4167,Lane Peek Towards Top Mid,Grim,0,0,0,0,0,0,T,85
4168,Arch Side,Grim,0,0,0,30,0,30,CT,85
4169,Arch Side,Grim,2,1,1,265,162,103,T,85
4170,Default Plant A Site,Grim,0,0,0,0,0,0,CT,85
4171,Default Plant A Site,Grim,1,1,0,78,72,6,T,85
4172,Bottom Mid exposed to Top Mid,Grim,0,0,0,0,0,0,CT,85
4173,Bottom Mid exposed to Top Mid,Grim,0,0,0,0,15,-15,T,85
4174,CT Near Well,Grim,0,0,0,0,0,0,CT,85
4175,CT Near Well,Grim,0,0,0,0,0,0,T,85
4176,Apps T Side Stairs,Grim,0,0,0,0,0,0,CT,85
4177,Apps T Side Stairs,Grim,0,0,0,0,0,0,T,85
4178,Top Graveyard,Grim,0,0,0,0,0,0,CT,85
4179,Top Graveyard,Grim,0,0,0,0,0,0,T,85
4180,CT Boost,Grim,0,0,0,0,0,0,CT,85
4181,CT Boost,Grim,0,0,0,0,0,0,T,85
4182,Top Mid Chokepoint,ropz,0,0,0,0,0,0,CT,51
4183,Top Mid Chokepoint,ropz,0,2,-2,66,200,-134,T,51
4184,Top Mid Lane Side ,ropz,1,0,1,34,0,34,CT,51
4185,Top Mid Lane Side ,ropz,6,1,5,397,236,161,T,51
4186,Behind Coffins Playing the B Site Cross,ropz,0,0,0,0,0,0,CT,51
4187,Behind Coffins Playing the B Site Cross,ropz,0,0,0,0,0,0,T,51
4188,Top Balcony ,ropz,1,2,-1,100,200,-100,CT,51
4189,Top Balcony ,ropz,0,2,-2,88,121,-33,T,51
4190,SecondMid,ropz,0,0,0,0,2,-2,CT,51
4191,SecondMid,ropz,2,1,1,200,64,136,T,51
4192,Chokepoint Entering B,ropz,0,0,0,0,0,0,CT,51
4193,Chokepoint Entering B,ropz,0,0,0,39,45,-6,T,51
4194,CT Peek Towards B Choke,ropz,1,0,1,102,48,54,CT,51
4195,CT Peek Towards B Choke,ropz,0,1,-1,0,58,-58,T,51
4196,Lane Side,ropz,0,0,0,26,0,26,CT,51
4197,Lane Side,ropz,1,1,0,94,100,-6,T,51
4198,Right Side Quadbox Peek for a CT,ropz,0,1,-1,33,6,27,CT,51
4199,Right Side Quadbox Peek for a CT,ropz,1,1,0,20,87,-67,T,51
4200,Boiler Room,ropz,1,0,1,100,0,100,CT,51
4201,Boiler Room,ropz,0,0,0,20,0,20,T,51
4202,Banana,ropz,0,1,-1,0,100,-100,CT,51
4203,Banana,ropz,0,0,0,0,0,0,T,51
4204,Pit Peek Towards Lane,ropz,4,1,3,419,100,319,CT,51
4205,Pit Peek Towards Lane,ropz,0,0,0,0,0,0,T,51
4206,Grill,ropz,0,0,0,0,0,0,CT,51
4207,Grill,ropz,0,1,-1,0,2,-2,T,51
4208,Back Alley,ropz,0,0,0,0,0,0,CT,51
4209,Back Alley,ropz,0,0,0,80,0,80,T,51
4210,Top Mid Arch Side,ropz,1,1,0,99,126,-27,CT,51
4211,Top Mid Arch Side,ropz,0,1,-1,27,100,-73,T,51
4212,Deep Apps Past Hallway,ropz,0,1,-1,20,100,-80,CT,51
4213,Deep Apps Past Hallway,ropz,0,0,0,65,0,65,T,51
4214,Apps Hallway,ropz,0,1,-1,0,20,-20,CT,51
4215,Apps Hallway,ropz,1,0,1,100,79,21,T,51
4216,Boiler Side Stairs,ropz,2,1,1,200,152,48,CT,51
4217,Boiler Side Stairs,ropz,0,1,-1,0,8,-8,T,51
4218,Construction,ropz,0,1,-1,0,100,-100,CT,51
4219,Construction,ropz,0,0,0,0,0,0,T,51
4220,B Site,ropz,0,0,0,0,0,0,CT,51
4221,B Site,ropz,0,1,-1,11,100,-89,T,51
4222,A Bombsite Close Left,ropz,0,0,0,0,0,0,CT,51
4223,A Bombsite Close Left,ropz,0,0,0,0,0,0,T,51
4224,Outside Library,ropz,0,0,0,0,30,-30,CT,51
4225,Outside Library,ropz,0,0,0,0,0,0,T,51
4226,1st Oranges,ropz,0,0,0,0,0,0,CT,51
4227,1st Oranges,ropz,4,1,3,262,100,162,T,51
4228,Underpass,ropz,0,0,0,0,0,0,CT,51
4229,Underpass,ropz,1,1,0,100,100,0,T,51
4230,CT Outside Construction,ropz,0,0,0,7,0,7,CT,51
4231,CT Outside Construction,ropz,0,0,0,0,0,0,T,51
4232,Bottom Graveyard,ropz,0,0,0,0,0,0,CT,51
4233,Bottom Graveyard,ropz,0,0,0,0,0,0,T,51
4234,Lane Patio,ropz,1,1,0,117,100,17,CT,51
4235,Lane Patio,ropz,0,0,0,0,0,0,T,51
4236,Apartments,ropz,0,1,-1,27,160,-133,CT,51
4237,Apartments,ropz,0,0,0,0,0,0,T,51
4238,Pit,ropz,1,0,1,100,0,100,CT,51
4239,Pit,ropz,0,0,0,0,0,0,T,51
4240,Arch Side Cubby,ropz,0,0,0,0,0,0,CT,51
4241,Arch Side Cubby,ropz,0,0,0,0,0,0,T,51
4242,CT Banana Half Wall Side,ropz,0,0,0,0,0,0,CT,51
4243,CT Banana Half Wall Side,ropz,2,0,2,188,10,178,T,51
4244,Lane Behind Pillar,ropz,0,1,-1,44,70,-26,CT,51
4245,Lane Behind Pillar,ropz,0,0,0,0,0,0,T,51
4246,Middle,ropz,0,0,0,0,0,0,CT,51
4247,Middle,ropz,1,0,1,118,45,73,T,51
4248,CT Near Well,ropz,0,0,0,0,0,0,CT,51
4249,CT Near Well,ropz,0,0,0,0,0,0,T,51
4250,CT Boost,ropz,0,0,0,0,0,0,CT,51
4251,CT Boost,ropz,0,0,0,0,0,0,T,51
4252,CT Speed Way,ropz,0,1,-1,0,100,-100,CT,51
4253,CT Speed Way,ropz,0,0,0,0,0,0,T,51
4254,A Site Behind Middle Boxes/Pillar hidden from Lane,ropz,0,0,0,0,0,0,CT,51
4255,A Site Behind Middle Boxes/Pillar hidden from Lane,ropz,0,0,0,0,0,0,T,51
4256,Arch Side,ropz,1,0,1,86,0,86,CT,51
4257,Arch Side,ropz,0,0,0,0,0,0,T,51
4258,CT Spawn ,ropz,0,1,-1,0,100,-100,CT,51
4259,CT Spawn ,ropz,0,0,0,0,0,0,T,51
4260,A Site,ropz,0,0,0,0,0,0,CT,51
4261,A Site,ropz,3,0,3,205,70,135,T,51
4262,Arch Side,AmaNEk,5,1,4,459,248,211,CT,59
4263,Arch Side,AmaNEk,3,2,1,283,235,48,T,59
4264,Pit Peek Towards Lane,AmaNEk,0,1,-1,0,94,-94,CT,59
4265,Pit Peek Towards Lane,AmaNEk,0,1,-1,26,100,-74,T,59
4266,A Site,AmaNEk,2,0,2,180,0,180,CT,59
4267,A Site,AmaNEk,0,2,-2,0,200,-200,T,59
4268,Apps T Side Stairs,AmaNEk,0,0,0,0,0,0,CT,59
4269,Apps T Side Stairs,AmaNEk,0,1,-1,1,108,-107,T,59
4270,Top Mid Arch Side,AmaNEk,2,0,2,253,78,175,CT,59
4271,Top Mid Arch Side,AmaNEk,1,1,0,99,180,-81,T,59
4272,Top Mid Chokepoint,AmaNEk,0,0,0,0,0,0,CT,59
4273,Top Mid Chokepoint,AmaNEk,1,0,1,17,0,17,T,59
4274,Top Mid Lane Side ,AmaNEk,1,0,1,100,0,100,CT,59
4275,Top Mid Lane Side ,AmaNEk,1,1,0,66,72,-6,T,59
4276,Top Balcony ,AmaNEk,0,0,0,0,4,-4,CT,59
4277,Top Balcony ,AmaNEk,2,1,1,213,100,113,T,59
4278,B Site,AmaNEk,0,0,0,0,0,0,CT,59
4279,B Site,AmaNEk,0,0,0,0,0,0,T,59
4280,CT Peek Towards B Choke,AmaNEk,1,0,1,100,8,92,CT,59
4281,CT Peek Towards B Choke,AmaNEk,1,0,1,100,16,84,T,59
4282,Pit Below Balcony,AmaNEk,0,0,0,0,0,0,CT,59
4283,Pit Below Balcony,AmaNEk,0,2,-2,0,180,-180,T,59
4284,Graveyard Stairs,AmaNEk,0,1,-1,0,100,-100,CT,59
4285,Graveyard Stairs,AmaNEk,1,0,1,2,13,-11,T,59
4286,Chokepoint Entering B,AmaNEk,0,0,0,70,2,68,CT,59
4287,Chokepoint Entering B,AmaNEk,2,2,0,291,252,39,T,59
4288,Deep Apps Past Hallway,AmaNEk,1,0,1,12,0,12,CT,59
4289,Deep Apps Past Hallway,AmaNEk,1,1,0,120,100,20,T,59
4290,Chokepoint Entrance onto A site from Library Side,AmaNEk,1,1,0,72,20,52,CT,59
4291,Chokepoint Entrance onto A site from Library Side,AmaNEk,0,0,0,0,68,-68,T,59
4292,Banana,AmaNEk,0,0,0,0,0,0,CT,59
4293,Banana,AmaNEk,0,2,-2,72,156,-84,T,59
4294,Lane Side,AmaNEk,1,0,1,100,0,100,CT,59
4295,Lane Side,AmaNEk,0,0,0,37,15,22,T,59
4296,CT Banana Half Wall Side,AmaNEk,0,0,0,0,0,0,CT,59
4297,CT Banana Half Wall Side,AmaNEk,0,1,-1,0,136,-136,T,59
4298,2nd Oranges,AmaNEk,1,1,0,124,100,24,CT,59
4299,2nd Oranges,AmaNEk,0,0,0,0,3,-3,T,59
4300,Grill,AmaNEk,0,0,0,0,0,0,CT,59
4301,Grill,AmaNEk,0,0,0,27,22,5,T,59
4302,1st Oranges,AmaNEk,0,0,0,0,0,0,CT,59
4303,1st Oranges,AmaNEk,0,1,-1,0,39,-39,T,59
4304,Construction,AmaNEk,1,0,1,99,0,99,CT,59
4305,Construction,AmaNEk,1,0,1,100,0,100,T,59
4306,A Site Right Side Middle Pillar,AmaNEk,0,1,-1,0,26,-26,CT,59
4307,A Site Right Side Middle Pillar,AmaNEk,0,0,0,0,0,0,T,59
4308,Dark,AmaNEk,0,0,0,0,0,0,CT,59
4309,Dark,AmaNEk,0,0,0,0,0,0,T,59
4310,CTCorridorDown,AmaNEk,0,1,-1,0,100,-100,CT,59
4311,CTCorridorDown,AmaNEk,0,0,0,0,0,0,T,59
4312,Top Hay Bales,AmaNEk,0,0,0,0,0,0,CT,59
4313,Top Hay Bales,AmaNEk,0,0,0,0,0,0,T,59
4314,B Site Cross for T's Exposed to CT and Quad,AmaNEk,0,0,0,0,0,0,CT,59
4315,B Site Cross for T's Exposed to CT and Quad,AmaNEk,2,1,1,129,26,103,T,59
4316,Beach,AmaNEk,0,0,0,0,0,0,CT,59
4317,Beach,AmaNEk,0,1,-1,0,65,-65,T,59
4318,Front Coffins,AmaNEk,0,0,0,0,0,0,CT,59
4319,Front Coffins,AmaNEk,0,1,-1,0,69,-69,T,59
4320,A Site Behind Default Boxes,AmaNEk,0,0,0,0,0,0,CT,59
4321,A Site Behind Default Boxes,AmaNEk,0,0,0,0,0,0,T,59
4322,Apartments Hallway Peek from T Side,AmaNEk,0,0,0,0,0,0,CT,59
4323,Apartments Hallway Peek from T Side,AmaNEk,0,0,0,0,0,0,T,59
4324,Behind Coffins Playing the B Site Cross,AmaNEk,2,0,2,47,0,47,CT,59
4325,Behind Coffins Playing the B Site Cross,AmaNEk,0,0,0,0,0,0,T,59
4326,Underpass,AmaNEk,0,0,0,0,0,0,CT,59
4327,Underpass,AmaNEk,0,0,0,0,0,0,T,59
4328,Arch Side CT Corner Peeking Towards Top Mid,AmaNEk,0,0,0,69,0,69,CT,59
4329,Arch Side CT Corner Peeking Towards Top Mid,AmaNEk,0,0,0,0,8,-8,T,59
4330,Boiler Side Stairs,AmaNEk,3,1,2,241,100,141,CT,59
4331,Boiler Side Stairs,AmaNEk,0,0,0,0,0,0,T,59
4332,Bottom Mid exposed to Top Mid,AmaNEk,0,0,0,0,0,0,CT,59
4333,Bottom Mid exposed to Top Mid,AmaNEk,0,0,0,0,0,0,T,59
4334,Top Coffins,AmaNEk,0,0,0,0,0,0,CT,59
4335,Top Coffins,AmaNEk,0,0,0,0,0,0,T,59
4336,CT Arch,AmaNEk,0,1,-1,0,100,-100,CT,59
4337,CT Arch,AmaNEk,1,0,1,100,0,100,T,59
4338,A Site Behind Middle Boxes/Pillar hidden from Lane,AmaNEk,0,0,0,40,0,40,CT,59
4339,A Site Behind Middle Boxes/Pillar hidden from Lane,AmaNEk,0,1,-1,0,32,-32,T,59
4340,Quad Box,AmaNEk,0,0,0,0,0,0,CT,59
4341,Quad Box,AmaNEk,1,0,1,148,0,148,T,59
4342,CT Boost,AmaNEk,1,0,1,20,0,20,CT,59
4343,CT Boost,AmaNEk,0,0,0,0,0,0,T,59
4344,CT Outside Construction,AmaNEk,0,0,0,0,0,0,CT,59
4345,CT Outside Construction,AmaNEk,0,0,0,0,0,0,T,59
4346,A Bombsite Back Site,AmaNEk,0,1,-1,22,154,-132,CT,59
4347,A Bombsite Back Site,AmaNEk,0,0,0,0,0,0,T,59
4348,Library,AmaNEk,0,1,-1,6,98,-92,CT,59
4349,Library,AmaNEk,0,0,0,0,0,0,T,59
4350,Apartments,yuurih,2,3,-1,384,307,77,CT,80
4351,Apartments,yuurih,0,1,-1,61,100,-39,T,80
4352,Top Balcony ,yuurih,1,1,0,16,16,0,CT,80
4353,Top Balcony ,yuurih,0,0,0,0,0,0,T,80
4354,B Site,yuurih,0,0,0,0,0,0,CT,80
4355,B Site,yuurih,3,1,2,95,98,-3,T,80
4356,Top Mid Lane Side ,yuurih,2,1,1,381,100,281,CT,80
4357,Top Mid Lane Side ,yuurih,2,2,0,220,346,-126,T,80
4358,Lane Behind Pillar,yuurih,0,0,0,1,0,1,CT,80
4359,Lane Behind Pillar,yuurih,0,2,-2,86,129,-43,T,80
4360,Lane Side,yuurih,0,1,-1,26,100,-74,CT,80
4361,Lane Side,yuurih,1,3,-2,100,397,-297,T,80
4362,Boiler Room,yuurih,3,3,0,256,330,-74,CT,80
4363,Boiler Room,yuurih,0,1,-1,20,100,-80,T,80
4364,Top Mid Chokepoint,yuurih,0,0,0,0,0,0,CT,80
4365,Top Mid Chokepoint,yuurih,0,2,-2,0,200,-200,T,80
4366,SecondMid,yuurih,0,1,-1,27,93,-66,CT,80
4367,SecondMid,yuurih,0,0,0,15,0,15,T,80
4368,Boiler Peek to Mid,yuurih,0,1,-1,51,100,-49,CT,80
4369,Boiler Peek to Mid,yuurih,1,1,0,100,101,-1,T,80
4370,Quad Box,yuurih,0,0,0,0,0,0,CT,80
4371,Quad Box,yuurih,0,1,-1,7,100,-93,T,80
4372,Boiler Side Stairs,yuurih,1,0,1,60,27,33,CT,80
4373,Boiler Side Stairs,yuurih,0,0,0,0,0,0,T,80
4374,CT Peek Towards B Choke,yuurih,0,0,0,0,0,0,CT,80
4375,CT Peek Towards B Choke,yuurih,0,2,-2,27,200,-173,T,80
4376,Chokepoint Entering B,yuurih,0,1,-1,76,100,-24,CT,80
4377,Chokepoint Entering B,yuurih,3,2,1,366,201,165,T,80
4378,Pit,yuurih,0,0,0,21,0,21,CT,80
4379,Pit,yuurih,0,1,-1,0,100,-100,T,80
4380,Top Mid Arch Side,yuurih,0,0,0,0,0,0,CT,80
4381,Top Mid Arch Side,yuurih,4,0,4,400,79,321,T,80
4382,Deep Apps Past Hallway,yuurih,1,0,1,100,84,16,CT,80
4383,Deep Apps Past Hallway,yuurih,0,0,0,58,25,33,T,80
4384,Pit Below Balcony,yuurih,2,1,1,200,73,127,CT,80
4385,Pit Below Balcony,yuurih,2,0,2,151,0,151,T,80
4386,A Site Behind Middle Boxes/Pillar hidden from Lane,yuurih,0,1,-1,0,41,-41,CT,80
4387,A Site Behind Middle Boxes/Pillar hidden from Lane,yuurih,0,0,0,0,0,0,T,80
4388,Middle,yuurih,0,0,0,0,0,0,CT,80
4389,Middle,yuurih,0,0,0,0,0,0,T,80
4390,Default Plant A Site,yuurih,0,0,0,0,0,0,CT,80
4391,Default Plant A Site,yuurih,1,0,1,100,0,100,T,80
4392,Construction,yuurih,0,0,0,0,0,0,CT,80
4393,Construction,yuurih,0,1,-1,0,15,-15,T,80
4394,Dark,yuurih,0,0,0,0,0,0,CT,80
4395,Dark,yuurih,1,0,1,55,0,55,T,80
4396,B Site Cross for T's Exposed to CT and Quad,yuurih,0,0,0,0,0,0,CT,80
4397,B Site Cross for T's Exposed to CT and Quad,yuurih,0,0,0,0,22,-22,T,80
4398,A Bombsite Close Left,yuurih,0,0,0,0,24,-24,CT,80
4399,A Bombsite Close Left,yuurih,0,1,-1,0,52,-52,T,80
4400,Grill,yuurih,0,0,0,0,0,0,CT,80
4401,Grill,yuurih,0,0,0,0,0,0,T,80
4402,CT Banana Sandbangs,yuurih,0,0,0,0,0,0,CT,80
4403,CT Banana Sandbangs,yuurih,1,1,0,126,100,26,T,80
4404,CT Outside Kitchen,yuurih,0,0,0,0,0,0,CT,80
4405,CT Outside Kitchen,yuurih,0,1,-1,0,100,-100,T,80
4406,Back Alley,yuurih,1,0,1,20,46,-26,CT,80
4407,Back Alley,yuurih,1,0,1,100,0,100,T,80
4408,Behind Coffins Playing the B Site Cross,yuurih,0,0,0,1,0,1,CT,80
4409,Behind Coffins Playing the B Site Cross,yuurih,2,0,2,160,0,160,T,80
4410,Logs,yuurih,0,0,0,0,0,0,CT,80
4411,Logs,yuurih,0,1,-1,53,100,-47,T,80
4412,Bottom Mid Banana,yuurih,0,1,-1,0,70,-70,CT,80
4413,Bottom Mid Banana,yuurih,0,0,0,27,0,27,T,80
4414,Apps Hallway,yuurih,0,0,0,15,0,15,CT,80
4415,Apps Hallway,yuurih,0,0,0,0,6,-6,T,80
4416,A Bombsite Back Site,yuurih,0,0,0,0,0,0,CT,80
4417,A Bombsite Back Site,yuurih,0,0,0,0,0,0,T,80
4418,Arch Side,yuurih,0,0,0,0,0,0,CT,80
4419,Arch Side,yuurih,0,0,0,0,0,0,T,80
4420,Apps T Side Stairs,yuurih,0,0,0,0,0,0,CT,80
4421,Apps T Side Stairs,yuurih,0,0,0,0,0,0,T,80
4422,1st Oranges,yuurih,0,0,0,0,0,0,CT,80
4423,1st Oranges,yuurih,0,0,0,0,0,0,T,80
4424,CT Banana Sandbags Right Corner,yuurih,0,0,0,0,0,0,CT,80
4425,CT Banana Sandbags Right Corner,yuurih,0,0,0,0,0,0,T,80
4426,CT Speed Way,yuurih,0,0,0,0,0,0,CT,80
4427,CT Speed Way,yuurih,0,0,0,0,0,0,T,80
4428,Top Graveyard,yuurih,0,0,0,0,0,0,CT,80
4429,Top Graveyard,yuurih,0,0,0,0,0,0,T,80
4430,CT Outside Construction,yuurih,0,1,-1,0,54,-54,CT,80
4431,CT Outside Construction,yuurih,0,0,0,0,0,0,T,80
4432,CT Outside Arch,yuurih,0,0,0,0,0,0,CT,80
4433,CT Outside Arch,yuurih,1,0,1,100,0,100,T,80
4434,Lane Patio,yuurih,2,1,1,211,100,111,CT,80
4435,Lane Patio,yuurih,0,0,0,0,78,-78,T,80
4436,Library,yuurih,0,0,0,0,0,0,CT,80
4437,Library,yuurih,0,1,-1,54,100,-46,T,80
4438,Deep CT Peeking Towards B Site,yuurih,0,1,-1,35,100,-65,CT,80
4439,Deep CT Peeking Towards B Site,yuurih,0,0,0,0,85,-85,T,80
4440,BackRoad,yuurih,0,0,0,0,0,0,CT,80
4441,BackRoad,yuurih,0,1,-1,0,66,-66,T,80
4442,Banana,yuurih,0,0,0,0,0,0,CT,80
4443,Banana,yuurih,0,1,-1,0,156,-156,T,80
4444,T Ramp Peeking Towards Mid,yuurih,0,0,0,0,0,0,CT,80
4445,T Ramp Peeking Towards Mid,yuurih,0,0,0,38,25,13,T,80
4446,Top Balcony ,EliGE,0,0,0,0,0,0,CT,85
4447,Top Balcony ,EliGE,1,2,-1,126,200,-74,T,85
4448,Lane Side,EliGE,0,1,-1,83,142,-59,CT,85
4449,Lane Side,EliGE,0,1,-1,131,100,31,T,85
4450,Arch Side,EliGE,2,2,0,346,200,146,CT,85
4451,Arch Side,EliGE,0,1,-1,232,111,121,T,85
4452,Chokepoint Entering B,EliGE,0,0,0,0,0,0,CT,85
4453,Chokepoint Entering B,EliGE,2,2,0,100,162,-62,T,85
4454,CT Peek Towards B Choke,EliGE,1,0,1,4,27,-23,CT,85
4455,CT Peek Towards B Choke,EliGE,0,1,-1,77,82,-5,T,85
4456,Top Mid Arch Side,EliGE,0,1,-1,119,103,16,CT,85
4457,Top Mid Arch Side,EliGE,0,1,-1,121,190,-69,T,85
4458,Behind Coffins Playing the B Site Cross,EliGE,0,3,-3,29,252,-223,CT,85
4459,Behind Coffins Playing the B Site Cross,EliGE,0,0,0,0,0,0,T,85
4460,CT Banana Half Wall Side,EliGE,0,0,0,0,0,0,CT,85
4461,CT Banana Half Wall Side,EliGE,0,2,-2,0,197,-197,T,85
4462,A Bombsite Close Left,EliGE,4,0,4,394,78,316,CT,85
4463,A Bombsite Close Left,EliGE,0,2,-2,1,173,-172,T,85
4464,Boiler Side Stairs,EliGE,1,2,-1,46,200,-154,CT,85
4465,Boiler Side Stairs,EliGE,1,0,1,100,49,51,T,85
4466,CT Outside Construction,EliGE,0,1,-1,0,84,-84,CT,85
4467,CT Outside Construction,EliGE,0,1,-1,0,100,-100,T,85
4468,Top Mid Lane Side ,EliGE,0,1,-1,33,100,-67,CT,85
4469,Top Mid Lane Side ,EliGE,1,0,1,201,107,94,T,85
4470,Pit Peek Towards Lane,EliGE,1,2,-1,142,220,-78,CT,85
4471,Pit Peek Towards Lane,EliGE,0,1,-1,0,78,-78,T,85
4472,Pit Below Balcony,EliGE,0,1,-1,88,100,-12,CT,85
4473,Pit Below Balcony,EliGE,0,1,-1,93,84,9,T,85
4474,B Site,EliGE,1,1,0,100,214,-114,CT,85
4475,B Site,EliGE,0,1,-1,0,9,-9,T,85
4476,A Site Right Side Middle Pillar,EliGE,1,1,0,77,97,-20,CT,85
4477,A Site Right Side Middle Pillar,EliGE,0,0,0,0,0,0,T,85
4478,CT Tree,EliGE,1,1,0,70,48,22,CT,85
4479,CT Tree,EliGE,0,0,0,0,0,0,T,85
4480,Banana,EliGE,0,0,0,0,0,0,CT,85
4481,Banana,EliGE,0,1,-1,32,181,-149,T,85
4482,1st Oranges,EliGE,0,0,0,0,0,0,CT,85
4483,1st Oranges,EliGE,0,1,-1,0,100,-100,T,85
4484,Boiler Peek to Mid,EliGE,1,1,0,128,100,28,CT,85
4485,Boiler Peek to Mid,EliGE,3,1,2,304,115,189,T,85
4486,Pit,EliGE,1,1,0,118,80,38,CT,85
4487,Pit,EliGE,0,1,-1,0,73,-73,T,85
4488,LowerMid,EliGE,1,1,0,121,100,21,CT,85
4489,LowerMid,EliGE,0,0,0,0,0,0,T,85
4490,Deep Apps Past Hallway,EliGE,0,0,0,0,0,0,CT,85
4491,Deep Apps Past Hallway,EliGE,0,0,0,0,0,0,T,85
4492,Bottom Mid exposed to Top Mid,EliGE,0,1,-1,0,100,-100,CT,85
4493,Bottom Mid exposed to Top Mid,EliGE,0,1,-1,0,100,-100,T,85
4494,Top Mid Chokepoint,EliGE,0,0,0,0,0,0,CT,85
4495,Top Mid Chokepoint,EliGE,1,1,0,100,129,-29,T,85
4496,A Bombsite Back Site,EliGE,0,0,0,0,0,0,CT,85
4497,A Bombsite Back Site,EliGE,0,2,-2,16,185,-169,T,85
4498,Apartments,EliGE,0,1,-1,55,126,-71,CT,85
4499,Apartments,EliGE,0,0,0,16,16,0,T,85
4500,Top Graveyard,EliGE,0,2,-2,102,200,-98,CT,85
4501,Top Graveyard,EliGE,0,0,0,0,0,0,T,85
4502,Apps T Side Stairs,EliGE,0,0,0,0,0,0,CT,85
4503,Apps T Side Stairs,EliGE,0,1,-1,29,100,-71,T,85
4504,A Site Behind Middle Boxes/Pillar hidden from Lane,EliGE,1,0,1,91,0,91,CT,85
4505,A Site Behind Middle Boxes/Pillar hidden from Lane,EliGE,0,0,0,0,0,0,T,85
4506,Deep CT Peeking Towards B Site,EliGE,1,0,1,100,104,-4,CT,85
4507,Deep CT Peeking Towards B Site,EliGE,0,0,0,0,0,0,T,85
4508,Lane Peek Towards Top Mid,EliGE,0,0,0,0,3,-3,CT,85
4509,Lane Peek Towards Top Mid,EliGE,0,0,0,0,0,0,T,85
4510,Apps Hallway,EliGE,0,0,0,0,0,0,CT,85
4511,Apps Hallway,EliGE,0,1,-1,37,98,-61,T,85
4512,Lane Patio,EliGE,0,1,-1,0,100,-100,CT,85
4513,Lane Patio,EliGE,0,0,0,0,0,0,T,85
4514,Underpass,EliGE,0,0,0,0,0,0,CT,85
4515,Underpass,EliGE,0,1,-1,0,100,-100,T,85
4516,Boiler Room,EliGE,0,0,0,0,0,0,CT,85
4517,Boiler Room,EliGE,1,0,1,100,25,75,T,85
4518,Arch Side Cubby,EliGE,0,0,0,0,0,0,CT,85
4519,Arch Side Cubby,EliGE,0,0,0,0,0,0,T,85
4520,Bottom Graveyard,EliGE,2,1,1,114,100,14,CT,85
4521,Bottom Graveyard,EliGE,0,0,0,0,0,0,T,85
4522,CT Banana Sandbangs,EliGE,0,0,0,13,0,13,CT,85
4523,CT Banana Sandbangs,EliGE,2,1,1,102,100,2,T,85
4524,B Site Cross for T's Exposed to CT and Quad,EliGE,1,0,1,189,0,189,CT,85
4525,B Site Cross for T's Exposed to CT and Quad,EliGE,1,0,1,47,21,26,T,85
4526,Apartments Hallway Peek from T Side,EliGE,0,0,0,0,0,0,CT,85
4527,Apartments Hallway Peek from T Side,EliGE,1,1,0,111,100,11,T,85
4528,A Site,EliGE,0,1,-1,0,13,-13,CT,85
4529,A Site,EliGE,1,0,1,19,0,19,T,85
4530,Chokepoint Entering B,Xyp9x,0,2,-2,41,201,-160,CT,106
4531,Chokepoint Entering B,Xyp9x,2,1,1,130,138,-8,T,106
4532,B Site,Xyp9x,2,2,0,248,200,48,CT,106
4533,B Site,Xyp9x,1,1,0,106,92,14,T,106
4534,Top Mid Lane Side ,Xyp9x,1,1,0,83,154,-71,CT,106
4535,Top Mid Lane Side ,Xyp9x,1,3,-2,58,300,-242,T,106
4536,A Bombsite Close Left,Xyp9x,0,4,-4,256,400,-144,CT,106
4537,A Bombsite Close Left,Xyp9x,0,0,0,0,0,0,T,106
4538,CT Peek Towards B Choke,Xyp9x,2,0,2,167,47,120,CT,106
4539,CT Peek Towards B Choke,Xyp9x,0,0,0,5,0,5,T,106
4540,Arch Side,Xyp9x,1,4,-3,189,344,-155,CT,106
4541,Arch Side,Xyp9x,0,0,0,88,45,43,T,106
4542,Banana,Xyp9x,0,0,0,0,25,-25,CT,106
4543,Banana,Xyp9x,1,0,1,142,42,100,T,106
4544,Behind Coffins Playing the B Site Cross,Xyp9x,0,2,-2,24,200,-176,CT,106
4545,Behind Coffins Playing the B Site Cross,Xyp9x,0,2,-2,54,154,-100,T,106
4546,Top Balcony ,Xyp9x,0,0,0,0,0,0,CT,106
4547,Top Balcony ,Xyp9x,1,2,-1,120,200,-80,T,106
4548,Lane Side,Xyp9x,1,0,1,67,0,67,CT,106
4549,Lane Side,Xyp9x,0,3,-3,0,213,-213,T,106
4550,CT Banana Half Wall Side,Xyp9x,1,1,0,193,119,74,CT,106
4551,CT Banana Half Wall Side,Xyp9x,1,3,-2,220,298,-78,T,106
4552,Apps T Side Stairs,Xyp9x,0,1,-1,0,25,-25,CT,106
4553,Apps T Side Stairs,Xyp9x,0,0,0,0,0,0,T,106
4554,2nd Oranges,Xyp9x,1,3,-2,274,300,-26,CT,106
4555,2nd Oranges,Xyp9x,0,0,0,0,0,0,T,106
4556,Top Mid Arch Side,Xyp9x,0,0,0,0,0,0,CT,106
4557,Top Mid Arch Side,Xyp9x,0,2,-2,0,238,-238,T,106
4558,A Bombsite Back Site,Xyp9x,1,1,0,100,100,0,CT,106
4559,A Bombsite Back Site,Xyp9x,0,0,0,0,0,0,T,106
4560,Chokepoint Entrance onto A site from Library Side,Xyp9x,2,2,0,77,150,-73,CT,106
4561,Chokepoint Entrance onto A site from Library Side,Xyp9x,0,0,0,0,0,0,T,106
4562,Top Mid Chokepoint,Xyp9x,1,0,1,100,0,100,CT,106
4563,Top Mid Chokepoint,Xyp9x,0,3,-3,33,300,-267,T,106
4564,Construction,Xyp9x,0,1,-1,89,100,-11,CT,106
4565,Construction,Xyp9x,0,0,0,0,0,0,T,106
4566,1st Oranges,Xyp9x,1,2,-1,357,200,157,CT,106
4567,1st Oranges,Xyp9x,0,0,0,0,0,0,T,106
4568,Pit Peek Towards Lane,Xyp9x,0,0,0,0,0,0,CT,106
4569,Pit Peek Towards Lane,Xyp9x,1,1,0,91,97,-6,T,106
4570,Pit Below Balcony,Xyp9x,0,1,-1,0,72,-72,CT,106
4571,Pit Below Balcony,Xyp9x,1,1,0,152,100,52,T,106
4572,Apps Hallway,Xyp9x,2,0,2,200,28,172,CT,106
4573,Apps Hallway,Xyp9x,0,2,-2,75,200,-125,T,106
4574,B Site Cross for T's Exposed to CT and Quad,Xyp9x,3,1,2,320,101,219,CT,106
4575,B Site Cross for T's Exposed to CT and Quad,Xyp9x,0,0,0,85,19,66,T,106
4576,Grill,Xyp9x,0,0,0,0,0,0,CT,106
4577,Grill,Xyp9x,2,1,1,195,107,88,T,106
4578,A Site,Xyp9x,0,2,-2,0,200,-200,CT,106
4579,A Site,Xyp9x,0,0,0,0,0,0,T,106
4580,Dark,Xyp9x,1,1,0,78,152,-74,CT,106
4581,Dark,Xyp9x,0,0,0,0,0,0,T,106
4582,A Site Behind Middle Boxes/Pillar hidden from Lane,Xyp9x,0,1,-1,14,100,-86,CT,106
4583,A Site Behind Middle Boxes/Pillar hidden from Lane,Xyp9x,0,0,0,0,0,0,T,106
4584,Lane Peek Towards Top Mid,Xyp9x,0,0,0,0,0,0,CT,106
4585,Lane Peek Towards Top Mid,Xyp9x,0,0,0,0,0,0,T,106
4586,Outside Library,Xyp9x,0,1,-1,0,20,-20,CT,106
4587,Outside Library,Xyp9x,0,0,0,0,0,0,T,106
4588,Boiler Side Stairs,Xyp9x,0,0,0,5,0,5,CT,106
4589,Boiler Side Stairs,Xyp9x,0,1,-1,73,186,-113,T,106
4590,Bottom Mid exposed to Top Mid,Xyp9x,0,0,0,0,0,0,CT,106
4591,Bottom Mid exposed to Top Mid,Xyp9x,2,1,1,103,100,3,T,106
4592,Behind B Site Back Pillar,Xyp9x,1,1,0,11,123,-112,CT,106
4593,Behind B Site Back Pillar,Xyp9x,0,0,0,0,0,0,T,106
4594,Logs,Xyp9x,0,0,0,43,0,43,CT,106
4595,Logs,Xyp9x,0,0,0,0,0,0,T,106
4596,Top Hay Bales,Xyp9x,0,0,0,0,0,0,CT,106
4597,Top Hay Bales,Xyp9x,0,1,-1,0,100,-100,T,106
4598,CT Arch,Xyp9x,0,1,-1,83,123,-40,CT,106
4599,CT Arch,Xyp9x,0,0,0,0,0,0,T,106
4600,Bottom Mid Banana,Xyp9x,0,0,0,0,0,0,CT,106
4601,Bottom Mid Banana,Xyp9x,0,0,0,0,0,0,T,106
4602,SecondMid,Xyp9x,0,0,0,0,0,0,CT,106
4603,SecondMid,Xyp9x,0,1,-1,22,111,-89,T,106
4604,Deep CT Peeking Towards B Site,Xyp9x,0,1,-1,0,100,-100,CT,106
4605,Deep CT Peeking Towards B Site,Xyp9x,0,0,0,0,0,0,T,106
4606,CT Outside Construction,Xyp9x,1,0,1,28,0,28,CT,106
4607,CT Outside Construction,Xyp9x,0,0,0,0,0,0,T,106
4608,Middle,Xyp9x,0,0,0,0,0,0,CT,106
4609,Middle,Xyp9x,0,0,0,36,0,36,T,106
4610,CT Spawn ,Xyp9x,1,0,1,96,0,96,CT,106
4611,CT Spawn ,Xyp9x,0,0,0,0,0,0,T,106
4612,A Site Right Side Middle Pillar,Xyp9x,0,1,-1,18,100,-82,CT,106
4613,A Site Right Side Middle Pillar,Xyp9x,0,0,0,0,0,0,T,106
4614,Top Mid Lane Side ,junior,2,3,-1,200,314,-114,CT,80
4615,Top Mid Lane Side ,junior,1,2,-1,137,174,-37,T,80
4616,CT Peek Towards B Choke,junior,1,2,-1,15,102,-87,CT,80
4617,CT Peek Towards B Choke,junior,0,0,0,0,0,0,T,80
4618,Top Mid Arch Side,junior,1,1,0,114,100,14,CT,80
4619,Top Mid Arch Side,junior,1,1,0,10,119,-109,T,80
4620,CT Banana Half Wall Side,junior,0,0,0,0,0,0,CT,80
4621,CT Banana Half Wall Side,junior,2,3,-1,129,347,-218,T,80
4622,Chokepoint Entering B,junior,0,1,-1,0,100,-100,CT,80
4623,Chokepoint Entering B,junior,2,1,1,282,27,255,T,80
4624,Lane Side,junior,6,1,5,579,125,454,CT,80
4625,Lane Side,junior,1,2,-1,147,146,1,T,80
4626,Pit,junior,0,2,-2,70,181,-111,CT,80
4627,Pit,junior,0,0,0,0,0,0,T,80
4628,Top Mid Chokepoint,junior,0,0,0,0,0,0,CT,80
4629,Top Mid Chokepoint,junior,0,0,0,0,32,-32,T,80
4630,Underpass,junior,0,0,0,0,0,0,CT,80
4631,Underpass,junior,0,2,-2,69,200,-131,T,80
4632,Pit Peek Towards Lane,junior,1,1,0,72,100,-28,CT,80
4633,Pit Peek Towards Lane,junior,0,0,0,0,0,0,T,80
4634,CT Outside Construction,junior,0,1,-1,0,100,-100,CT,80
4635,CT Outside Construction,junior,1,0,1,73,0,73,T,80
4636,A Bombsite Close Left,junior,0,0,0,0,0,0,CT,80
4637,A Bombsite Close Left,junior,1,1,0,74,94,-20,T,80
4638,Right Side Quadbox Peek for a CT,junior,0,0,0,0,0,0,CT,80
4639,Right Side Quadbox Peek for a CT,junior,0,2,-2,0,200,-200,T,80
4640,CT Banana Sandbangs,junior,0,0,0,0,98,-98,CT,80
4641,CT Banana Sandbangs,junior,1,1,0,65,138,-73,T,80
4642,Boiler Peek to Mid,junior,0,0,0,0,0,0,CT,80
4643,Boiler Peek to Mid,junior,0,0,0,0,0,0,T,80
4644,Dark,junior,0,0,0,0,0,0,CT,80
4645,Dark,junior,0,1,-1,19,27,-8,T,80
4646,B Site Cross for T's Exposed to CT and Quad,junior,0,0,0,0,0,0,CT,80
4647,B Site Cross for T's Exposed to CT and Quad,junior,0,1,-1,15,135,-120,T,80
4648,Front Coffins,junior,0,0,0,0,0,0,CT,80
4649,Front Coffins,junior,0,0,0,0,0,0,T,80
4650,Boiler Side Stairs,junior,0,1,-1,78,36,42,CT,80
4651,Boiler Side Stairs,junior,0,0,0,0,0,0,T,80
4652,Lane Peek Towards Top Mid,junior,0,0,0,0,0,0,CT,80
4653,Lane Peek Towards Top Mid,junior,0,0,0,0,14,-14,T,80
4654,B Site,junior,1,0,1,21,90,-69,CT,80
4655,B Site,junior,0,1,-1,22,183,-161,T,80
4656,A Site,junior,0,1,-1,0,99,-99,CT,80
4657,A Site,junior,0,0,0,0,0,0,T,80
4658,Deep Apps Past Hallway,junior,0,0,0,0,0,0,CT,80
4659,Deep Apps Past Hallway,junior,0,1,-1,39,100,-61,T,80
4660,LowerMid,junior,0,0,0,0,0,0,CT,80
4661,LowerMid,junior,0,1,-1,0,100,-100,T,80
4662,Grill,junior,0,0,0,0,0,0,CT,80
4663,Grill,junior,1,1,0,100,69,31,T,80
4664,Construction,junior,1,0,1,100,0,100,CT,80
4665,Construction,junior,1,0,1,20,0,20,T,80
4666,CT Outside Arch,junior,0,0,0,85,0,85,CT,80
4667,CT Outside Arch,junior,0,1,-1,0,32,-32,T,80
4668,Behind Coffins Playing the B Site Cross,junior,0,0,0,0,0,0,CT,80
4669,Behind Coffins Playing the B Site Cross,junior,1,1,0,100,86,14,T,80
4670,Bottom Mid exposed to Top Mid,junior,0,0,0,0,0,0,CT,80
4671,Bottom Mid exposed to Top Mid,junior,0,0,0,0,0,0,T,80
4672,CT Spawn ,junior,0,0,0,0,0,0,CT,80
4673,CT Spawn ,junior,0,0,0,0,0,0,T,80
4674,Outside Library,junior,0,0,0,0,0,0,CT,80
4675,Outside Library,junior,0,0,0,0,0,0,T,80
4676,Arch Side,junior,0,0,0,72,20,52,CT,80
4677,Arch Side,junior,0,0,0,0,0,0,T,80
4678,CT Speed Way,junior,1,0,1,100,0,100,CT,80
4679,CT Speed Way,junior,0,0,0,0,0,0,T,80
4680,Next to Library Cubby,junior,0,0,0,0,0,0,CT,80
4681,Next to Library Cubby,junior,0,0,0,0,0,0,T,80
4682,2nd Oranges,junior,0,0,0,0,0,0,CT,80
4683,2nd Oranges,junior,2,0,2,40,0,40,T,80
4684,Deep CT Peeking Towards B Site,junior,0,1,-1,0,86,-86,CT,80
4685,Deep CT Peeking Towards B Site,junior,0,0,0,0,0,0,T,80
4686,Lane Patio,junior,1,0,1,100,0,100,CT,80
4687,Lane Patio,junior,1,0,1,100,0,100,T,80
4688,SecondMid,junior,0,0,0,0,0,0,CT,80
4689,SecondMid,junior,0,0,0,0,0,0,T,80
4690,TopofMid,junior,1,0,1,100,0,100,CT,80
4691,TopofMid,junior,0,0,0,0,0,0,T,80
4692,Lane Behind Pillar,junior,1,1,0,126,151,-25,CT,80
4693,Lane Behind Pillar,junior,0,0,0,0,0,0,T,80
4694,Back Alley,junior,0,0,0,0,0,0,CT,80
4695,Back Alley,junior,0,0,0,0,0,0,T,80
4696,Bottom Mid Banana,junior,0,0,0,0,0,0,CT,80
4697,Bottom Mid Banana,junior,1,0,1,100,64,36,T,80
4698,Middle,junior,0,0,0,0,0,0,CT,80
4699,Middle,junior,1,0,1,100,36,64,T,80
4700,Banana,junior,0,0,0,0,0,0,CT,80
4701,Banana,junior,0,0,0,147,167,-20,T,80
4702,Apps T Side Stairs,junior,0,0,0,0,0,0,CT,80
4703,Apps T Side Stairs,junior,0,0,0,0,0,0,T,80
4704,Lane Side,dycha,1,2,-1,2,200,-198,CT,64
4705,Lane Side,dycha,1,1,0,52,82,-30,T,64
4706,CT Banana Half Wall Side,dycha,0,2,-2,41,171,-130,CT,64
4707,CT Banana Half Wall Side,dycha,1,1,0,170,99,71,T,64
4708,Banana,dycha,0,0,0,0,0,0,CT,64
4709,Banana,dycha,0,5,-5,18,555,-537,T,64
4710,A Site,dycha,2,2,0,219,271,-52,CT,64
4711,A Site,dycha,0,0,0,0,0,0,T,64
4712,A Bombsite Close Left,dycha,3,1,2,286,80,206,CT,64
4713,A Bombsite Close Left,dycha,0,0,0,73,0,73,T,64
4714,Top Mid Lane Side ,dycha,1,0,1,176,90,86,CT,64
4715,Top Mid Lane Side ,dycha,0,0,0,0,0,0,T,64
4716,Behind Coffins Playing the B Site Cross,dycha,0,3,-3,2,300,-298,CT,64
4717,Behind Coffins Playing the B Site Cross,dycha,0,0,0,0,0,0,T,64
4718,Pit Below Balcony,dycha,0,2,-2,159,200,-41,CT,64
4719,Pit Below Balcony,dycha,0,0,0,0,0,0,T,64
4720,Apps T Side Stairs,dycha,0,1,-1,0,41,-41,CT,64
4721,Apps T Side Stairs,dycha,0,0,0,0,0,0,T,64
4722,Boiler Side Stairs,dycha,1,2,-1,100,200,-100,CT,64
4723,Boiler Side Stairs,dycha,0,0,0,0,0,0,T,64
4724,A Site Behind Default Boxes,dycha,1,1,0,191,128,63,CT,64
4725,A Site Behind Default Boxes,dycha,0,0,0,0,0,0,T,64
4726,Apps Hallway,dycha,1,0,1,114,8,106,CT,64
4727,Apps Hallway,dycha,0,0,0,0,0,0,T,64
4728,Pit Peek Towards Lane,dycha,3,2,1,305,368,-63,CT,64
4729,Pit Peek Towards Lane,dycha,1,0,1,100,56,44,T,64
4730,B Site,dycha,1,0,1,92,16,76,CT,64
4731,B Site,dycha,0,0,0,0,0,0,T,64
4732,Pit,dycha,1,1,0,115,42,73,CT,64
4733,Pit,dycha,0,0,0,52,0,52,T,64
4734,Default Plant A Site,dycha,0,0,0,0,0,0,CT,64
4735,Default Plant A Site,dycha,0,1,-1,0,100,-100,T,64
4736,Bottom Mid exposed to Top Mid,dycha,0,0,0,0,0,0,CT,64
4737,Bottom Mid exposed to Top Mid,dycha,0,1,-1,0,19,-19,T,64
4738,Outside Library,dycha,1,0,1,46,0,46,CT,64
4739,Outside Library,dycha,0,0,0,0,0,0,T,64
4740,CT Peek Towards B Choke,dycha,3,1,2,181,152,29,CT,64
4741,CT Peek Towards B Choke,dycha,0,1,-1,22,86,-64,T,64
4742,Arch Side,dycha,0,0,0,40,0,40,CT,64
4743,Arch Side,dycha,0,1,-1,0,100,-100,T,64
4744,A Site Behind Middle Boxes/Pillar hidden from Lane,dycha,1,1,0,202,25,177,CT,64
4745,A Site Behind Middle Boxes/Pillar hidden from Lane,dycha,2,0,2,88,0,88,T,64
4746,Chokepoint Entering B,dycha,0,0,0,109,88,21,CT,64
4747,Chokepoint Entering B,dycha,0,0,0,0,14,-14,T,64
4748,Top Balcony ,dycha,1,0,1,100,0,100,CT,64
4749,Top Balcony ,dycha,1,0,1,89,0,89,T,64
4750,Top Mid Chokepoint,dycha,0,0,0,0,0,0,CT,64
4751,Top Mid Chokepoint,dycha,0,1,-1,0,100,-100,T,64
4752,Top Coffins,dycha,1,1,0,73,109,-36,CT,64
4753,Top Coffins,dycha,0,0,0,0,0,0,T,64
4754,A Bombsite Back Site,dycha,0,0,0,0,0,0,CT,64
4755,A Bombsite Back Site,dycha,0,0,0,0,0,0,T,64
4756,Deep Apps Past Hallway,dycha,3,0,3,256,0,256,CT,64
4757,Deep Apps Past Hallway,dycha,0,0,0,0,0,0,T,64
4758,Underpass,dycha,0,0,0,0,0,0,CT,64
4759,Underpass,dycha,1,1,0,156,32,124,T,64
4760,A Site Left Side Middle Boxes,dycha,1,0,1,104,0,104,CT,64
4761,A Site Left Side Middle Boxes,dycha,0,0,0,0,0,0,T,64
4762,Top Mid Arch Side,dycha,0,0,0,0,0,0,CT,64
4763,Top Mid Arch Side,dycha,0,1,-1,54,100,-46,T,64
4764,CT Boost,dycha,0,0,0,0,0,0,CT,64
4765,CT Boost,dycha,0,0,0,0,0,0,T,64
4766,Grill,dycha,0,1,-1,8,100,-92,CT,64
4767,Grill,dycha,0,0,0,0,0,0,T,64
4768,Deep CT Peeking Towards B Site,dycha,1,1,0,127,126,1,CT,64
4769,Deep CT Peeking Towards B Site,dycha,0,0,0,0,0,0,T,64
4770,Dark,dycha,0,0,0,0,0,0,CT,64
4771,Dark,dycha,0,0,0,0,0,0,T,64
4772,CT Banana Barrels,dycha,0,1,-1,0,136,-136,CT,64
4773,CT Banana Barrels,dycha,0,0,0,0,24,-24,T,64
4774,Chokepoint Entrance onto A site from Library Side,dycha,0,0,0,0,0,0,CT,64
4775,Chokepoint Entrance onto A site from Library Side,dycha,0,1,-1,0,100,-100,T,64
4776,Back Alley,dycha,0,0,0,0,0,0,CT,64
4777,Back Alley,dycha,0,0,0,0,0,0,T,64
4778,T Apps Bridge ,dycha,0,1,-1,0,100,-100,CT,64
4779,T Apps Bridge ,dycha,0,0,0,0,0,0,T,64
4780,Front Coffins,dycha,0,0,0,0,0,0,CT,64
4781,Front Coffins,dycha,0,0,0,0,0,0,T,64
4782,Apartments Hallway Peek from T Side,dycha,0,0,0,0,0,0,CT,64
4783,Apartments Hallway Peek from T Side,dycha,0,0,0,0,44,-44,T,64
4784,Apartments,dycha,0,1,-1,138,183,-45,CT,64
4785,Apartments,dycha,0,0,0,0,0,0,T,64
4786,CT Speed Way,dycha,0,1,-1,0,91,-91,CT,64
4787,CT Speed Way,dycha,0,0,0,0,0,0,T,64
4788,Boiler Room,dycha,0,1,-1,0,17,-17,CT,64
4789,Boiler Room,dycha,0,0,0,0,0,0,T,64
4790,Logs,dycha,0,0,0,0,0,0,CT,64
4791,Logs,dycha,0,1,-1,0,117,-117,T,64
4792,T Ramp Peeking Towards Mid,dycha,1,0,1,15,0,15,CT,64
4793,T Ramp Peeking Towards Mid,dycha,1,1,0,100,248,-148,T,64
4794,Banana,TeSeS,0,1,-1,19,9,10,CT,65
4795,Banana,TeSeS,1,1,0,94,227,-133,T,65
4796,Arch Side,TeSeS,3,1,2,98,185,-87,CT,65
4797,Arch Side,TeSeS,4,0,4,341,36,305,T,65
4798,Top Mid Arch Side,TeSeS,1,3,-2,120,214,-94,CT,65
4799,Top Mid Arch Side,TeSeS,1,1,0,134,106,28,T,65
4800,CT Banana Half Wall Side,TeSeS,2,0,2,137,94,43,CT,65
4801,CT Banana Half Wall Side,TeSeS,0,1,-1,33,122,-89,T,65
4802,Lane Side,TeSeS,1,1,0,132,100,32,CT,65
4803,Lane Side,TeSeS,0,1,-1,0,100,-100,T,65
4804,Chokepoint Entering B,TeSeS,2,1,1,235,166,69,CT,65
4805,Chokepoint Entering B,TeSeS,1,1,0,132,100,32,T,65
4806,CT Peek Towards B Choke,TeSeS,1,0,1,68,0,68,CT,65
4807,CT Peek Towards B Choke,TeSeS,0,0,0,0,0,0,T,65
4808,Pit Below Balcony,TeSeS,0,0,0,0,0,0,CT,65
4809,Pit Below Balcony,TeSeS,0,2,-2,34,150,-116,T,65
4810,Chokepoint Entrance onto A site from Library Side,TeSeS,2,2,0,265,240,25,CT,65
4811,Chokepoint Entrance onto A site from Library Side,TeSeS,0,0,0,0,29,-29,T,65
4812,Top Mid Lane Side ,TeSeS,2,0,2,150,52,98,CT,65
4813,Top Mid Lane Side ,TeSeS,0,1,-1,0,100,-100,T,65
4814,A Site,TeSeS,0,2,-2,45,175,-130,CT,65
4815,A Site,TeSeS,1,1,0,100,68,32,T,65
4816,Top Balcony ,TeSeS,0,0,0,0,0,0,CT,65
4817,Top Balcony ,TeSeS,0,0,0,0,50,-50,T,65
4818,CT Spawn ,TeSeS,0,0,0,0,0,0,CT,65
4819,CT Spawn ,TeSeS,1,1,0,100,56,44,T,65
4820,A Bombsite Close Left,TeSeS,1,1,0,78,69,9,CT,65
4821,A Bombsite Close Left,TeSeS,0,0,0,24,0,24,T,65
4822,Outside Library,TeSeS,1,2,-1,125,201,-76,CT,65
4823,Outside Library,TeSeS,0,0,0,0,3,-3,T,65
4824,Grill,TeSeS,0,0,0,0,0,0,CT,65
4825,Grill,TeSeS,0,1,-1,130,52,78,T,65
4826,Next to Library Cubby,TeSeS,0,0,0,0,0,0,CT,65
4827,Next to Library Cubby,TeSeS,0,0,0,0,0,0,T,65
4828,CT Banana Sandbangs,TeSeS,3,0,3,190,34,156,CT,65
4829,CT Banana Sandbangs,TeSeS,0,2,-2,0,200,-200,T,65
4830,CT Arch,TeSeS,0,0,0,0,1,-1,CT,65
4831,CT Arch,TeSeS,1,0,1,73,44,29,T,65
4832,SecondMid,TeSeS,0,0,0,0,0,0,CT,65
4833,SecondMid,TeSeS,1,2,-1,157,158,-1,T,65
4834,Middle,TeSeS,0,1,-1,45,100,-55,CT,65
4835,Middle,TeSeS,0,0,0,1,0,1,T,65
4836,Pit Peek Towards Lane,TeSeS,0,0,0,0,0,0,CT,65
4837,Pit Peek Towards Lane,TeSeS,0,0,0,0,0,0,T,65
4838,Top Hay Bales,TeSeS,0,0,0,0,0,0,CT,65
4839,Top Hay Bales,TeSeS,1,1,0,127,90,37,T,65
4840,B Site Cross for T's Exposed to CT and Quad,TeSeS,0,0,0,27,0,27,CT,65
4841,B Site Cross for T's Exposed to CT and Quad,TeSeS,0,1,-1,30,120,-90,T,65
4842,Top Mid Chokepoint,TeSeS,0,0,0,9,0,9,CT,65
4843,Top Mid Chokepoint,TeSeS,0,1,-1,0,47,-47,T,65
4844,A Bombsite Back Site,TeSeS,0,0,0,0,0,0,CT,65
4845,A Bombsite Back Site,TeSeS,0,0,0,0,0,0,T,65
4846,CT Boost,TeSeS,2,1,1,119,100,19,CT,65
4847,CT Boost,TeSeS,0,0,0,0,0,0,T,65
4848,Deep CT Peeking Towards B Site,TeSeS,0,0,0,0,0,0,CT,65
4849,Deep CT Peeking Towards B Site,TeSeS,0,0,0,0,31,-31,T,65
4850,A Site Behind Middle Boxes/Pillar hidden from Lane,TeSeS,0,0,0,0,0,0,CT,65
4851,A Site Behind Middle Boxes/Pillar hidden from Lane,TeSeS,0,1,-1,0,100,-100,T,65
4852,CT Outside Arch,TeSeS,1,0,1,100,0,100,CT,65
4853,CT Outside Arch,TeSeS,0,0,0,0,0,0,T,65
4854,CT Speed Way,TeSeS,0,0,0,0,0,0,CT,65
4855,CT Speed Way,TeSeS,0,0,0,0,0,0,T,65
4856,Arch Side Cubby,TeSeS,0,0,0,0,0,0,CT,65
4857,Arch Side Cubby,TeSeS,0,0,0,0,0,0,T,65
4858,CT Outside Construction,TeSeS,1,0,1,32,0,32,CT,65
4859,CT Outside Construction,TeSeS,0,1,-1,0,69,-69,T,65
4860,A Site Right Side Middle Pillar,TeSeS,1,0,1,53,0,53,CT,65
4861,A Site Right Side Middle Pillar,TeSeS,0,1,-1,24,94,-70,T,65
4862,B Site,TeSeS,0,0,0,0,0,0,CT,65
4863,B Site,TeSeS,1,0,1,142,54,88,T,65
4864,CT Near Well,TeSeS,0,1,-1,0,100,-100,CT,65
4865,CT Near Well,TeSeS,0,0,0,0,0,0,T,65
4866,Behind Coffins Playing the B Site Cross,TeSeS,0,0,0,0,0,0,CT,65
4867,Behind Coffins Playing the B Site Cross,TeSeS,0,1,-1,0,32,-32,T,65
4868,Bottom Graveyard,TeSeS,0,0,0,0,0,0,CT,65
4869,Bottom Graveyard,TeSeS,0,0,0,0,0,0,T,65
4870,2nd Oranges,TeSeS,1,1,0,120,100,20,CT,65
4871,2nd Oranges,TeSeS,0,0,0,0,0,0,T,65
4872,Logs,TeSeS,0,1,-1,0,85,-85,CT,65
4873,Logs,TeSeS,0,0,0,0,0,0,T,65
4874,Banana,karrigan,0,2,-2,111,200,-89,CT,74
4875,Banana,karrigan,3,3,0,372,497,-125,T,74
4876,CT Banana Half Wall Side,karrigan,5,1,4,545,349,196,CT,74
4877,CT Banana Half Wall Side,karrigan,3,3,0,275,306,-31,T,74
4878,CT Peek Towards B Choke,karrigan,1,3,-2,347,215,132,CT,74
4879,CT Peek Towards B Choke,karrigan,2,2,0,198,200,-2,T,74
4880,Chokepoint Entering B,karrigan,1,0,1,139,54,85,CT,74
4881,Chokepoint Entering B,karrigan,1,3,-2,242,207,35,T,74
4882,CT Banana Sandbangs,karrigan,2,2,0,263,158,105,CT,74
4883,CT Banana Sandbangs,karrigan,1,0,1,100,43,57,T,74
4884,Top Mid Arch Side,karrigan,0,0,0,1,0,1,CT,74
4885,Top Mid Arch Side,karrigan,1,1,0,100,131,-31,T,74
4886,Top Mid Lane Side ,karrigan,0,1,-1,0,100,-100,CT,74
4887,Top Mid Lane Side ,karrigan,1,1,0,100,52,48,T,74
4888,Top Mid Chokepoint,karrigan,0,0,0,0,0,0,CT,74
4889,Top Mid Chokepoint,karrigan,1,2,-1,95,222,-127,T,74
4890,CT Banana Barrels,karrigan,0,3,-3,64,187,-123,CT,74
4891,CT Banana Barrels,karrigan,0,0,0,0,0,0,T,74
4892,Logs,karrigan,2,1,1,154,93,61,CT,74
4893,Logs,karrigan,0,0,0,0,66,-66,T,74
4894,Arch Side,karrigan,1,1,0,144,54,90,CT,74
4895,Arch Side,karrigan,0,1,-1,81,29,52,T,74
4896,Lane Patio,karrigan,0,0,0,0,0,0,CT,74
4897,Lane Patio,karrigan,0,0,0,0,0,0,T,74
4898,Apps T Side Stairs,karrigan,0,0,0,0,0,0,CT,74
4899,Apps T Side Stairs,karrigan,0,1,-1,68,83,-15,T,74
4900,B Site,karrigan,0,0,0,13,0,13,CT,74
4901,B Site,karrigan,0,1,-1,54,64,-10,T,74
4902,Behind Coffins Playing the B Site Cross,karrigan,0,1,-1,0,100,-100,CT,74
4903,Behind Coffins Playing the B Site Cross,karrigan,0,0,0,0,0,0,T,74
4904,Bottom Mid exposed to Top Mid,karrigan,0,1,-1,142,136,6,CT,74
4905,Bottom Mid exposed to Top Mid,karrigan,0,1,-1,0,100,-100,T,74
4906,T Ramp Peeking Towards Mid,karrigan,0,0,0,0,0,0,CT,74
4907,T Ramp Peeking Towards Mid,karrigan,1,1,0,164,117,47,T,74
4908,Deep CT Peeking Towards B Site,karrigan,0,0,0,0,0,0,CT,74
4909,Deep CT Peeking Towards B Site,karrigan,0,1,-1,0,49,-49,T,74
4910,2nd Oranges,karrigan,0,0,0,0,0,0,CT,74
4911,2nd Oranges,karrigan,1,0,1,75,0,75,T,74
4912,SecondMid,karrigan,0,0,0,0,0,0,CT,74
4913,SecondMid,karrigan,0,2,-2,0,199,-199,T,74
4914,Top Balcony ,karrigan,0,1,-1,80,100,-20,CT,74
4915,Top Balcony ,karrigan,0,0,0,0,0,0,T,74
4916,A Bombsite Back Site,karrigan,0,0,0,0,0,0,CT,74
4917,A Bombsite Back Site,karrigan,0,1,-1,0,77,-77,T,74
4918,Quad Box,karrigan,0,0,0,0,0,0,CT,74
4919,Quad Box,karrigan,1,0,1,100,0,100,T,74
4920,Outside Library,karrigan,0,0,0,53,0,53,CT,74
4921,Outside Library,karrigan,0,1,-1,26,100,-74,T,74
4922,B Site Cross for T's Exposed to CT and Quad,karrigan,0,0,0,16,0,16,CT,74
4923,B Site Cross for T's Exposed to CT and Quad,karrigan,0,0,0,25,0,25,T,74
4924,Lane Side,karrigan,2,0,2,17,0,17,CT,74
4925,Lane Side,karrigan,2,1,1,148,142,6,T,74
4926,Default Plant A Site,karrigan,0,0,0,0,0,0,CT,74
4927,Default Plant A Site,karrigan,0,0,0,0,0,0,T,74
4928,Next to Library Cubby,karrigan,0,1,-1,0,100,-100,CT,74
4929,Next to Library Cubby,karrigan,0,0,0,34,0,34,T,74
4930,Middle,karrigan,2,1,1,127,121,6,CT,74
4931,Middle,karrigan,2,0,2,157,111,46,T,74
4932,CT Outside Construction,karrigan,0,0,0,0,0,0,CT,74
4933,CT Outside Construction,karrigan,0,0,0,0,0,0,T,74
4934,Top Graveyard,karrigan,0,0,0,0,0,0,CT,74
4935,Top Graveyard,karrigan,0,1,-1,0,96,-96,T,74
4936,Top Coffins,karrigan,0,0,0,0,0,0,CT,74
4937,Top Coffins,karrigan,0,0,0,0,0,0,T,74
4938,1st Oranges,karrigan,3,1,2,261,84,177,CT,74
4939,1st Oranges,karrigan,0,0,0,0,0,0,T,74
4940,Pit Peek Towards Lane,karrigan,0,0,0,0,0,0,CT,74
4941,Pit Peek Towards Lane,karrigan,0,0,0,0,0,0,T,74
4942,Chokepoint Entrance onto A site from Library Side,karrigan,0,1,-1,0,100,-100,CT,74
4943,Chokepoint Entrance onto A site from Library Side,karrigan,0,0,0,0,0,0,T,74
4944,A Site,karrigan,0,0,0,0,0,0,CT,74
4945,A Site,karrigan,0,1,-1,0,80,-80,T,74
4946,Front Coffins,karrigan,0,0,0,0,0,0,CT,74
4947,Front Coffins,karrigan,1,1,0,7,61,-54,T,74
4948,CT Outside Kitchen,karrigan,0,0,0,0,0,0,CT,74
4949,CT Outside Kitchen,karrigan,0,0,0,0,0,0,T,74
4950,TopofMid,karrigan,0,0,0,0,0,0,CT,74
4951,TopofMid,karrigan,0,1,-1,0,78,-78,T,74
4952,CT Banana Sandbags Right Corner,karrigan,0,1,-1,26,51,-25,CT,74
4953,CT Banana Sandbags Right Corner,karrigan,0,0,0,0,2,-2,T,74
4954,Library,karrigan,1,1,0,264,100,164,CT,74
4955,Library,karrigan,0,0,0,0,0,0,T,74
4956,CT Banana Half Wall Side,stavn,2,3,-1,322,359,-37,CT,65
4957,CT Banana Half Wall Side,stavn,2,1,1,236,99,137,T,65
4958,Banana,stavn,1,0,1,100,0,100,CT,65
4959,Banana,stavn,1,1,0,171,308,-137,T,65
4960,Chokepoint Entering B,stavn,4,3,1,498,305,193,CT,65
4961,Chokepoint Entering B,stavn,1,3,-2,64,279,-215,T,65
4962,CT Banana Sandbangs,stavn,5,1,4,490,208,282,CT,65
4963,CT Banana Sandbangs,stavn,1,1,0,100,139,-39,T,65
4964,A Site Behind Default Boxes,stavn,0,2,-2,28,115,-87,CT,65
4965,A Site Behind Default Boxes,stavn,0,1,-1,0,96,-96,T,65
4966,CT Outside Construction,stavn,0,2,-2,80,200,-120,CT,65
4967,CT Outside Construction,stavn,0,1,-1,0,100,-100,T,65
4968,Arch Side,stavn,1,1,0,32,160,-128,CT,65
4969,Arch Side,stavn,1,1,0,73,100,-27,T,65
4970,Outside Library,stavn,0,1,-1,0,12,-12,CT,65
4971,Outside Library,stavn,0,0,0,0,0,0,T,65
4972,CT Arch,stavn,0,1,-1,77,92,-15,CT,65
4973,CT Arch,stavn,0,0,0,0,0,0,T,65
4974,Grill,stavn,0,0,0,0,0,0,CT,65
4975,Grill,stavn,0,2,-2,80,129,-49,T,65
4976,Boiler Side Stairs,stavn,1,1,0,40,91,-51,CT,65
4977,Boiler Side Stairs,stavn,0,0,0,33,0,33,T,65
4978,A Bombsite Close Left,stavn,0,0,0,0,0,0,CT,65
4979,A Bombsite Close Left,stavn,0,1,-1,0,78,-78,T,65
4980,Logs,stavn,0,0,0,0,0,0,CT,65
4981,Logs,stavn,1,0,1,138,0,138,T,65
4982,CT Tree,stavn,0,0,0,44,0,44,CT,65
4983,CT Tree,stavn,0,1,-1,0,84,-84,T,65
4984,Bathroom,stavn,0,1,-1,0,74,-74,CT,65
4985,Bathroom,stavn,0,0,0,0,0,0,T,65
4986,Lane Behind Pillar,stavn,0,0,0,0,0,0,CT,65
4987,Lane Behind Pillar,stavn,0,0,0,0,0,0,T,65
4988,Behind Coffins Playing the B Site Cross,stavn,0,0,0,0,0,0,CT,65
4989,Behind Coffins Playing the B Site Cross,stavn,0,0,0,0,0,0,T,65
4990,Construction,stavn,0,0,0,0,0,0,CT,65
4991,Construction,stavn,0,1,-1,35,49,-14,T,65
4992,Pit Below Balcony,stavn,0,0,0,0,0,0,CT,65
4993,Pit Below Balcony,stavn,0,0,0,0,0,0,T,65
4994,Default Plant A Site,stavn,0,0,0,0,0,0,CT,65
4995,Default Plant A Site,stavn,0,0,0,0,0,0,T,65
4996,Left Side Quadbox Peek for a CT,stavn,0,0,0,0,0,0,CT,65
4997,Left Side Quadbox Peek for a CT,stavn,0,0,0,0,0,0,T,65
4998,Quad Box,stavn,1,1,0,79,95,-16,CT,65
4999,Quad Box,stavn,0,0,0,0,0,0,T,65
5000,Top Coffins,stavn,0,0,0,0,3,-3,CT,65
5001,Top Coffins,stavn,0,0,0,0,0,0,T,65
5002,A Site,stavn,0,0,0,0,0,0,CT,65
5003,A Site,stavn,0,0,0,0,0,0,T,65
5004,Library,stavn,0,0,0,0,0,0,CT,65
5005,Library,stavn,0,0,0,0,0,0,T,65
5006,CT Peek Towards B Choke,stavn,0,0,0,0,0,0,CT,65
5007,CT Peek Towards B Choke,stavn,1,0,1,59,114,-55,T,65
5008,CT Spawn ,stavn,1,1,0,79,100,-21,CT,65
5009,CT Spawn ,stavn,0,0,0,0,0,0,T,65
5010,CT Speed Way,stavn,1,0,1,117,27,90,CT,65
5011,CT Speed Way,stavn,0,0,0,0,0,0,T,65
5012,Top Mid Arch Side,stavn,0,0,0,0,0,0,CT,65
5013,Top Mid Arch Side,stavn,2,0,2,130,92,38,T,65
5014,Top Graveyard,stavn,0,0,0,0,0,0,CT,65
5015,Top Graveyard,stavn,0,0,0,0,0,0,T,65
5016,Graveyard Stairs,stavn,0,0,0,0,0,0,CT,65
5017,Graveyard Stairs,stavn,0,1,-1,26,29,-3,T,65
5018,Deep CT Peeking Towards B Site,stavn,0,0,0,0,0,0,CT,65
5019,Deep CT Peeking Towards B Site,stavn,0,1,-1,0,100,-100,T,65
5020,Lane Side,stavn,1,0,1,1,0,1,CT,65
5021,Lane Side,stavn,2,0,2,200,92,108,T,65
5022,Lane Patio,stavn,0,0,0,0,9,-9,CT,65
5023,Lane Patio,stavn,0,0,0,0,0,0,T,65
5024,Top Mid Lane Side ,stavn,1,1,0,18,68,-50,CT,65
5025,Top Mid Lane Side ,stavn,0,0,0,36,0,36,T,65
5026,Middle,stavn,0,1,-1,13,100,-87,CT,65
5027,Middle,stavn,0,0,0,101,0,101,T,65
5028,TopofMid,stavn,0,0,0,0,0,0,CT,65
5029,TopofMid,stavn,0,1,-1,4,22,-18,T,65
5030,1st Oranges,stavn,0,0,0,0,0,0,CT,65
5031,1st Oranges,stavn,1,1,0,61,116,-55,T,65
5032,Bottom Mid Banana,stavn,0,0,0,0,0,0,CT,65
5033,Bottom Mid Banana,stavn,1,0,1,130,2,128,T,65
5034,Top Mid Chokepoint,stavn,0,0,0,0,0,0,CT,65
5035,Top Mid Chokepoint,stavn,1,1,0,162,100,62,T,65
5036,Kitchen,stavn,0,0,0,0,0,0,CT,65
5037,Kitchen,stavn,0,0,0,0,0,0,T,65
5038,T Ramp Peeking Towards Mid,stavn,0,0,0,0,0,0,CT,65
5039,T Ramp Peeking Towards Mid,stavn,0,0,0,0,8,-8,T,65
5040,Top Mid Lane Side ,huNter-,0,2,-2,137,200,-63,CT,59
5041,Top Mid Lane Side ,huNter-,1,1,0,84,100,-16,T,59
5042,Top Balcony ,huNter-,0,1,-1,68,100,-32,CT,59
5043,Top Balcony ,huNter-,1,4,-3,183,419,-236,T,59
5044,Deep Apps Past Hallway,huNter-,1,1,0,100,100,0,CT,59
5045,Deep Apps Past Hallway,huNter-,0,4,-4,0,399,-399,T,59
5046,Top Mid Arch Side,huNter-,1,1,0,100,100,0,CT,59
5047,Top Mid Arch Side,huNter-,0,0,0,27,52,-25,T,59
5048,Lane Patio,huNter-,3,3,0,335,275,60,CT,59
5049,Lane Patio,huNter-,0,1,-1,16,100,-84,T,59
5050,Chokepoint Entering B,huNter-,0,1,-1,115,71,44,CT,59
5051,Chokepoint Entering B,huNter-,1,2,-1,112,148,-36,T,59
5052,B Site,huNter-,0,0,0,0,0,0,CT,59
5053,B Site,huNter-,0,0,0,0,0,0,T,59
5054,Boiler Side Stairs,huNter-,2,0,2,229,12,217,CT,59
5055,Boiler Side Stairs,huNter-,0,2,-2,0,210,-210,T,59
5056,Lane Side,huNter-,5,1,4,469,56,413,CT,59
5057,Lane Side,huNter-,1,1,0,100,127,-27,T,59
5058,A Site,huNter-,1,0,1,78,0,78,CT,59
5059,A Site,huNter-,1,2,-1,100,119,-19,T,59
5060,Pit,huNter-,0,0,0,0,0,0,CT,59
5061,Pit,huNter-,1,1,0,118,98,20,T,59
5062,Apartments,huNter-,0,0,0,0,0,0,CT,59
5063,Apartments,huNter-,1,1,0,100,101,-1,T,59
5064,Behind Coffins Playing the B Site Cross,huNter-,0,1,-1,35,100,-65,CT,59
5065,Behind Coffins Playing the B Site Cross,huNter-,0,1,-1,0,100,-100,T,59
5066,CT Outside Construction,huNter-,0,0,0,0,0,0,CT,59
5067,CT Outside Construction,huNter-,0,0,0,0,0,0,T,59
5068,Boiler Peek to Mid,huNter-,0,0,0,0,0,0,CT,59
5069,Boiler Peek to Mid,huNter-,0,0,0,39,72,-33,T,59
5070,Bottom Mid Banana,huNter-,0,0,0,0,0,0,CT,59
5071,Bottom Mid Banana,huNter-,0,1,-1,0,100,-100,T,59
5072,CT Banana Half Wall Side,huNter-,1,1,0,100,126,-26,CT,59
5073,CT Banana Half Wall Side,huNter-,0,1,-1,0,97,-97,T,59
5074,Top Mid Chokepoint,huNter-,0,0,0,0,0,0,CT,59
5075,Top Mid Chokepoint,huNter-,0,0,0,0,0,0,T,59
5076,A Bombsite Close Left,huNter-,0,0,0,0,0,0,CT,59
5077,A Bombsite Close Left,huNter-,1,1,0,74,73,1,T,59
5078,Grill,huNter-,0,0,0,0,0,0,CT,59
5079,Grill,huNter-,0,1,-1,0,42,-42,T,59
5080,Middle,huNter-,1,0,1,100,0,100,CT,59
5081,Middle,huNter-,0,0,0,0,0,0,T,59
5082,Top Hay Bales,huNter-,0,0,0,0,0,0,CT,59
5083,Top Hay Bales,huNter-,0,0,0,0,0,0,T,59
5084,T Ramp Peeking Towards Mid,huNter-,0,0,0,0,0,0,CT,59
5085,T Ramp Peeking Towards Mid,huNter-,0,0,0,0,0,0,T,59
5086,Chokepoint Entrance onto A site from Library Side,huNter-,0,0,0,30,0,30,CT,59
5087,Chokepoint Entrance onto A site from Library Side,huNter-,0,0,0,0,26,-26,T,59
5088,B Site Cross for T's Exposed to CT and Quad,huNter-,0,0,0,0,0,0,CT,59
5089,B Site Cross for T's Exposed to CT and Quad,huNter-,1,1,0,32,138,-106,T,59
5090,Bottom Mid exposed to Top Mid,huNter-,0,1,-1,76,100,-24,CT,59
5091,Bottom Mid exposed to Top Mid,huNter-,0,0,0,0,0,0,T,59
5092,Boiler Room,huNter-,0,1,-1,0,100,-100,CT,59
5093,Boiler Room,huNter-,0,0,0,0,0,0,T,59
5094,Apartments Hallway Peek from T Side,huNter-,0,0,0,0,0,0,CT,59
5095,Apartments Hallway Peek from T Side,huNter-,0,0,0,0,0,0,T,59
5096,A Site Right Side Middle Pillar,huNter-,1,1,0,127,100,27,CT,59
5097,A Site Right Side Middle Pillar,huNter-,0,0,0,0,0,0,T,59
5098,Arch Side,huNter-,2,1,1,313,135,178,CT,59
5099,Arch Side,huNter-,0,0,0,0,0,0,T,59
5100,Library,huNter-,0,0,0,0,0,0,CT,59
5101,Library,huNter-,1,0,1,100,0,100,T,59
5102,Top Coffins,huNter-,0,0,0,0,0,0,CT,59
5103,Top Coffins,huNter-,0,0,0,0,0,0,T,59
5104,CT Outside Kitchen,huNter-,0,0,0,0,0,0,CT,59
5105,CT Outside Kitchen,huNter-,0,1,-1,0,92,-92,T,59
5106,Back Alley,huNter-,1,0,1,100,0,100,CT,59
5107,Back Alley,huNter-,0,0,0,0,0,0,T,59
5108,A Site Behind Middle Boxes/Pillar hidden from Lane,huNter-,0,1,-1,0,14,-14,CT,59
5109,A Site Behind Middle Boxes/Pillar hidden from Lane,huNter-,0,0,0,0,0,0,T,59
5110,SecondMid,huNter-,0,0,0,0,0,0,CT,59
5111,SecondMid,huNter-,0,0,0,0,5,-5,T,59
5112,Pit Below Balcony,huNter-,0,1,-1,75,100,-25,CT,59
5113,Pit Below Balcony,huNter-,0,0,0,0,0,0,T,59
5114,CT Peek Towards B Choke,huNter-,2,0,2,247,52,195,CT,59
5115,CT Peek Towards B Choke,huNter-,0,0,0,0,0,0,T,59
5116,Pit Peek Towards Lane,huNter-,0,0,0,0,0,0,CT,59
5117,Pit Peek Towards Lane,huNter-,0,0,0,0,0,0,T,59
5118,Apps T Side Stairs,huNter-,1,0,1,100,44,56,CT,59
5119,Apps T Side Stairs,huNter-,0,0,0,0,0,0,T,59
5120,CT Banana Half Wall Side,NiKo,4,1,3,393,330,63,CT,59
5121,CT Banana Half Wall Side,NiKo,0,1,-1,27,118,-91,T,59
5122,Top Mid Chokepoint,NiKo,0,1,-1,0,100,-100,CT,59
5123,Top Mid Chokepoint,NiKo,0,1,-1,32,100,-68,T,59
5124,Banana,NiKo,1,1,0,56,73,-17,CT,59
5125,Banana,NiKo,0,0,0,22,140,-118,T,59
5126,Lane Side,NiKo,0,1,-1,0,100,-100,CT,59
5127,Lane Side,NiKo,2,2,0,146,167,-21,T,59
5128,Top Mid Lane Side ,NiKo,0,0,0,0,0,0,CT,59
5129,Top Mid Lane Side ,NiKo,0,4,-4,81,269,-188,T,59
5130,Arch Side,NiKo,2,1,1,178,10,168,CT,59
5131,Arch Side,NiKo,0,0,0,0,0,0,T,59
5132,B Site,NiKo,2,0,2,72,2,70,CT,59
5133,B Site,NiKo,1,0,1,18,0,18,T,59
5134,CT Banana Sandbags Right Corner,NiKo,1,0,1,140,0,140,CT,59
5135,CT Banana Sandbags Right Corner,NiKo,0,0,0,0,0,0,T,59
5136,CT Peek Towards B Choke,NiKo,2,0,2,105,151,-46,CT,59
5137,CT Peek Towards B Choke,NiKo,0,0,0,0,0,0,T,59
5138,Pit,NiKo,0,0,0,0,0,0,CT,59
5139,Pit,NiKo,0,1,-1,27,150,-123,T,59
5140,B Site Cross for T's Exposed to CT and Quad,NiKo,1,1,0,112,50,62,CT,59
5141,B Site Cross for T's Exposed to CT and Quad,NiKo,0,1,-1,0,100,-100,T,59
5142,Top Coffins,NiKo,0,1,-1,80,19,61,CT,59
5143,Top Coffins,NiKo,0,0,0,0,0,0,T,59
5144,CT Banana Sandbangs,NiKo,2,1,1,229,103,126,CT,59
5145,CT Banana Sandbangs,NiKo,2,0,2,143,0,143,T,59
5146,Chokepoint Entering B,NiKo,1,0,1,202,0,202,CT,59
5147,Chokepoint Entering B,NiKo,0,1,-1,0,122,-122,T,59
5148,Grill,NiKo,0,0,0,0,0,0,CT,59
5149,Grill,NiKo,0,0,0,0,0,0,T,59
5150,Top Mid Arch Side,NiKo,4,0,4,333,61,272,CT,59
5151,Top Mid Arch Side,NiKo,1,0,1,100,42,58,T,59
5152,CT Banana Barrels,NiKo,0,0,0,0,0,0,CT,59
5153,CT Banana Barrels,NiKo,0,0,0,0,0,0,T,59
5154,Deep Apps Past Hallway,NiKo,0,0,0,0,0,0,CT,59
5155,Deep Apps Past Hallway,NiKo,0,2,-2,59,194,-135,T,59
5156,CT Near Well,NiKo,0,1,-1,104,100,4,CT,59
5157,CT Near Well,NiKo,0,0,0,0,0,0,T,59
5158,Back Alley,NiKo,1,0,1,32,0,32,CT,59
5159,Back Alley,NiKo,0,0,0,0,0,0,T,59
5160,Construction,NiKo,0,0,0,0,0,0,CT,59
5161,Construction,NiKo,0,0,0,0,0,0,T,59
5162,Dumpster,NiKo,0,0,0,0,0,0,CT,59
5163,Dumpster,NiKo,0,1,-1,0,12,-12,T,59
5164,Apps Hallway,NiKo,0,0,0,0,0,0,CT,59
5165,Apps Hallway,NiKo,0,1,-1,0,6,-6,T,59
5166,Chokepoint Entrance onto A site from Library Side,NiKo,0,0,0,0,0,0,CT,59
5167,Chokepoint Entrance onto A site from Library Side,NiKo,0,1,-1,0,24,-24,T,59
5168,A Bombsite Close Left,NiKo,0,0,0,0,0,0,CT,59
5169,A Bombsite Close Left,NiKo,0,0,0,20,0,20,T,59
5170,Quad Box,NiKo,0,1,-1,32,100,-68,CT,59
5171,Quad Box,NiKo,0,0,0,0,0,0,T,59
5172,Graveyard Stairs,NiKo,0,0,0,0,0,0,CT,59
5173,Graveyard Stairs,NiKo,0,1,-1,0,83,-83,T,59
5174,Bottom Mid exposed to Top Mid,NiKo,0,0,0,0,0,0,CT,59
5175,Bottom Mid exposed to Top Mid,NiKo,0,1,-1,81,100,-19,T,59
5176,Arch Side Cubby,NiKo,0,1,-1,0,101,-101,CT,59
5177,Arch Side Cubby,NiKo,0,0,0,0,0,0,T,59
5178,Boiler Side Stairs,NiKo,0,0,0,0,0,0,CT,59
5179,Boiler Side Stairs,NiKo,0,1,-1,0,96,-96,T,59
5180,Logs,NiKo,1,0,1,100,0,100,CT,59
5181,Logs,NiKo,0,0,0,0,0,0,T,59
5182,Behind Coffins Playing the B Site Cross,NiKo,1,0,1,44,0,44,CT,59
5183,Behind Coffins Playing the B Site Cross,NiKo,1,0,1,68,16,52,T,59
5184,Boiler Room,NiKo,0,1,-1,0,100,-100,CT,59
5185,Boiler Room,NiKo,0,0,0,0,0,0,T,59
5186,Right Side Quadbox Peek for a CT,NiKo,1,0,1,100,0,100,CT,59
5187,Right Side Quadbox Peek for a CT,NiKo,0,1,-1,0,59,-59,T,59
5188,Deep CT Peeking Towards B Site,NiKo,1,1,0,144,100,44,CT,59
5189,Deep CT Peeking Towards B Site,NiKo,0,0,0,0,0,0,T,59
5190,A Site Behind Middle Boxes/Pillar hidden from Lane,NiKo,0,0,0,0,0,0,CT,59
5191,A Site Behind Middle Boxes/Pillar hidden from Lane,NiKo,0,1,-1,0,63,-63,T,59
5192,TopofMid,NiKo,0,0,0,0,0,0,CT,59
5193,TopofMid,NiKo,0,0,0,0,0,0,T,59
5194,A Site Right Side Middle Pillar,NiKo,0,0,0,0,0,0,CT,59
5195,A Site Right Side Middle Pillar,NiKo,0,0,0,0,0,0,T,59
5196,TRamp,NiKo,0,0,0,0,0,0,CT,59
5197,TRamp,NiKo,0,0,0,0,0,0,T,59
5198,2nd Oranges,NiKo,1,1,0,116,39,77,CT,59
5199,2nd Oranges,NiKo,0,0,0,52,19,33,T,59
5200,Left Side Quadbox Peek for a CT,NiKo,0,0,0,0,0,0,CT,59
5201,Left Side Quadbox Peek for a CT,NiKo,0,1,-1,0,64,-64,T,59
5202,CT Spawn ,NiKo,0,0,0,0,0,0,CT,59
5203,CT Spawn ,NiKo,0,0,0,0,0,0,T,59
5204,T Ramp Peeking Towards Mid,NiKo,0,0,0,0,0,0,CT,59
5205,T Ramp Peeking Towards Mid,NiKo,0,0,0,57,139,-82,T,59
5206,Lane Side,refrezh,3,5,-2,392,386,6,CT,65
5207,Lane Side,refrezh,1,0,1,80,0,80,T,65
5208,B Site,refrezh,2,1,1,198,190,8,CT,65
5209,B Site,refrezh,0,1,-1,0,100,-100,T,65
5210,Top Balcony ,refrezh,1,1,0,100,100,0,CT,65
5211,Top Balcony ,refrezh,1,2,-1,153,269,-116,T,65
5212,Top Mid Lane Side ,refrezh,0,0,0,0,0,0,CT,65
5213,Top Mid Lane Side ,refrezh,0,0,0,0,0,0,T,65
5214,Middle,refrezh,2,0,2,185,0,185,CT,65
5215,Middle,refrezh,0,2,-2,166,200,-34,T,65
5216,Chokepoint Entering B,refrezh,0,0,0,104,0,104,CT,65
5217,Chokepoint Entering B,refrezh,2,1,1,178,298,-120,T,65
5218,CT Peek Towards B Choke,refrezh,1,1,0,133,183,-50,CT,65
5219,CT Peek Towards B Choke,refrezh,0,0,0,0,0,0,T,65
5220,Grill,refrezh,0,0,0,0,0,0,CT,65
5221,Grill,refrezh,0,1,-1,0,100,-100,T,65
5222,Behind Coffins Playing the B Site Cross,refrezh,0,0,0,0,0,0,CT,65
5223,Behind Coffins Playing the B Site Cross,refrezh,1,1,0,66,97,-31,T,65
5224,Arch Side,refrezh,1,0,1,100,0,100,CT,65
5225,Arch Side,refrezh,1,1,0,100,180,-80,T,65
5226,Balcony,refrezh,0,0,0,0,0,0,CT,65
5227,Balcony,refrezh,1,1,0,100,100,0,T,65
5228,Outside Library,refrezh,0,0,0,0,0,0,CT,65
5229,Outside Library,refrezh,0,0,0,0,0,0,T,65
5230,T Ramp Peeking Towards Mid,refrezh,0,0,0,0,0,0,CT,65
5231,T Ramp Peeking Towards Mid,refrezh,0,0,0,0,0,0,T,65
5232,Deep Apps Past Hallway,refrezh,0,0,0,0,0,0,CT,65
5233,Deep Apps Past Hallway,refrezh,1,0,1,100,78,22,T,65
5234,Apps Hallway,refrezh,0,0,0,0,34,-34,CT,65
5235,Apps Hallway,refrezh,0,1,-1,0,100,-100,T,65
5236,CT Banana Sandbangs,refrezh,0,0,0,31,24,7,CT,65
5237,CT Banana Sandbangs,refrezh,0,2,-2,9,119,-110,T,65
5238,Chokepoint Entrance onto A site from Library Side,refrezh,0,0,0,0,0,0,CT,65
5239,Chokepoint Entrance onto A site from Library Side,refrezh,0,0,0,0,0,0,T,65
5240,Pit Below Balcony,refrezh,0,0,0,82,0,82,CT,65
5241,Pit Below Balcony,refrezh,0,1,-1,105,97,8,T,65
5242,Front Coffins,refrezh,0,0,0,0,0,0,CT,65
5243,Front Coffins,refrezh,0,0,0,0,0,0,T,65
5244,Next to Library Cubby,refrezh,0,0,0,0,0,0,CT,65
5245,Next to Library Cubby,refrezh,0,0,0,0,0,0,T,65
5246,Lane Patio,refrezh,2,0,2,173,65,108,CT,65
5247,Lane Patio,refrezh,0,1,-1,0,89,-89,T,65
5248,Boiler Peek to Mid,refrezh,0,0,0,0,0,0,CT,65
5249,Boiler Peek to Mid,refrezh,1,0,1,2,0,2,T,65
5250,Lane Behind Pillar,refrezh,0,1,-1,147,178,-31,CT,65
5251,Lane Behind Pillar,refrezh,0,0,0,0,0,0,T,65
5252,CT Outside Construction,refrezh,0,1,-1,43,100,-57,CT,65
5253,CT Outside Construction,refrezh,0,0,0,0,0,0,T,65
5254,A Site Right Side Middle Pillar,refrezh,0,0,0,0,0,0,CT,65
5255,A Site Right Side Middle Pillar,refrezh,0,0,0,61,0,61,T,65
5256,A Site Behind Default Boxes,refrezh,0,1,-1,0,100,-100,CT,65
5257,A Site Behind Default Boxes,refrezh,0,0,0,0,0,0,T,65
5258,Apartments,refrezh,0,0,0,0,0,0,CT,65
5259,Apartments,refrezh,0,1,-1,63,100,-37,T,65
5260,B Site Cross for T's Exposed to CT and Quad,refrezh,0,0,0,0,0,0,CT,65
5261,B Site Cross for T's Exposed to CT and Quad,refrezh,0,1,-1,27,79,-52,T,65
5262,Pit,refrezh,2,1,1,165,32,133,CT,65
5263,Pit,refrezh,0,0,0,0,0,0,T,65
5264,Arch Side CT Corner Peeking Towards Top Mid,refrezh,0,1,-1,0,100,-100,CT,65
5265,Arch Side CT Corner Peeking Towards Top Mid,refrezh,0,0,0,0,0,0,T,65
5266,A Bombsite Close Left,refrezh,0,0,0,18,0,18,CT,65
5267,A Bombsite Close Left,refrezh,0,0,0,0,0,0,T,65
5268,Bottom Mid exposed to Top Mid,refrezh,0,1,-1,0,100,-100,CT,65
5269,Bottom Mid exposed to Top Mid,refrezh,0,0,0,0,0,0,T,65
5270,Top Coffins,refrezh,0,0,0,0,0,0,CT,65
5271,Top Coffins,refrezh,0,0,0,0,0,0,T,65
5272,Right Side Quadbox Peek for a CT,refrezh,0,0,0,0,0,0,CT,65
5273,Right Side Quadbox Peek for a CT,refrezh,1,0,1,127,0,127,T,65
5274,Top Mid Chokepoint,refrezh,0,0,0,15,0,15,CT,65
5275,Top Mid Chokepoint,refrezh,0,1,-1,27,101,-74,T,65
5276,Bottom Mid Banana,refrezh,0,1,-1,0,100,-100,CT,65
5277,Bottom Mid Banana,refrezh,0,0,0,0,0,0,T,65
5278,1st Oranges,refrezh,1,1,0,100,100,0,CT,65
5279,1st Oranges,refrezh,0,0,0,0,0,0,T,65
5280,SecondMid,refrezh,0,0,0,0,0,0,CT,65
5281,SecondMid,refrezh,0,0,0,13,11,2,T,65
5282,Quad Box,refrezh,0,0,0,0,0,0,CT,65
5283,Quad Box,refrezh,0,0,0,0,0,0,T,65
5284,Apps T Side Stairs,refrezh,0,0,0,0,4,-4,CT,65
5285,Apps T Side Stairs,refrezh,2,1,1,147,7,140,T,65
5286,Dark,refrezh,1,0,1,10,0,10,CT,65
5287,Dark,refrezh,0,0,0,0,0,0,T,65
5288,Arch Side Cubby,refrezh,0,0,0,0,0,0,CT,65
5289,Arch Side Cubby,refrezh,0,0,0,0,0,0,T,65
5290,CT Arch,refrezh,0,0,0,0,0,0,CT,65
5291,CT Arch,refrezh,0,1,-1,27,100,-73,T,65
5292,Lane Side,JACKZ,1,3,-2,122,205,-83,CT,59
5293,Lane Side,JACKZ,0,2,-2,51,194,-143,T,59
5294,Top Balcony ,JACKZ,0,1,-1,27,194,-167,CT,59
5295,Top Balcony ,JACKZ,1,3,-2,167,251,-84,T,59
5296,Banana,JACKZ,0,0,0,0,0,0,CT,59
5297,Banana,JACKZ,0,3,-3,223,512,-289,T,59
5298,A Bombsite Close Left,JACKZ,0,0,0,0,0,0,CT,59
5299,A Bombsite Close Left,JACKZ,1,4,-3,147,338,-191,T,59
5300,Boiler Side Stairs,JACKZ,1,2,-1,154,194,-40,CT,59
5301,Boiler Side Stairs,JACKZ,0,0,0,0,0,0,T,59
5302,CT Banana Half Wall Side,JACKZ,0,0,0,0,0,0,CT,59
5303,CT Banana Half Wall Side,JACKZ,2,2,0,210,66,144,T,59
5304,Top Mid Lane Side ,JACKZ,0,0,0,116,3,113,CT,59
5305,Top Mid Lane Side ,JACKZ,0,0,0,0,0,0,T,59
5306,A Site,JACKZ,2,2,0,212,200,12,CT,59
5307,A Site,JACKZ,0,0,0,0,0,0,T,59
5308,T Ramp Peeking Towards Mid,JACKZ,0,0,0,0,0,0,CT,59
5309,T Ramp Peeking Towards Mid,JACKZ,1,1,0,100,128,-28,T,59
5310,Top Mid Arch Side,JACKZ,0,0,0,0,0,0,CT,59
5311,Top Mid Arch Side,JACKZ,0,1,-1,0,179,-179,T,59
5312,Logs,JACKZ,0,1,-1,66,74,-8,CT,59
5313,Logs,JACKZ,0,1,-1,60,100,-40,T,59
5314,Chokepoint Entrance onto A site from Library Side,JACKZ,0,0,0,5,0,5,CT,59
5315,Chokepoint Entrance onto A site from Library Side,JACKZ,0,1,-1,0,71,-71,T,59
5316,Grill,JACKZ,1,1,0,58,100,-42,CT,59
5317,Grill,JACKZ,0,0,0,0,0,0,T,59
5318,CT Peek Towards B Choke,JACKZ,2,0,2,167,0,167,CT,59
5319,CT Peek Towards B Choke,JACKZ,0,0,0,0,0,0,T,59
5320,Top Mid Chokepoint,JACKZ,0,0,0,0,0,0,CT,59
5321,Top Mid Chokepoint,JACKZ,2,1,1,161,100,61,T,59
5322,CT Banana Barrels,JACKZ,0,0,0,0,0,0,CT,59
5323,CT Banana Barrels,JACKZ,0,0,0,0,0,0,T,59
5324,CT Boost,JACKZ,0,1,-1,0,100,-100,CT,59
5325,CT Boost,JACKZ,0,1,-1,0,100,-100,T,59
5326,Dark,JACKZ,0,0,0,0,0,0,CT,59
5327,Dark,JACKZ,0,0,0,0,0,0,T,59
5328,CT Banana Sandbangs,JACKZ,0,0,0,0,0,0,CT,59
5329,CT Banana Sandbangs,JACKZ,2,0,2,181,102,79,T,59
5330,Front Coffins,JACKZ,0,0,0,0,0,0,CT,59
5331,Front Coffins,JACKZ,0,1,-1,0,42,-42,T,59
5332,Deep Apps Past Hallway,JACKZ,0,1,-1,88,100,-12,CT,59
5333,Deep Apps Past Hallway,JACKZ,0,0,0,0,0,0,T,59
5334,Lane Behind Pillar,JACKZ,1,1,0,92,66,26,CT,59
5335,Lane Behind Pillar,JACKZ,0,0,0,0,0,0,T,59
5336,Apps Hallway,JACKZ,0,0,0,0,0,0,CT,59
5337,Apps Hallway,JACKZ,0,1,-1,0,40,-40,T,59
5338,Pit Below Balcony,JACKZ,0,1,-1,0,6,-6,CT,59
5339,Pit Below Balcony,JACKZ,0,0,0,0,0,0,T,59
5340,Lane Peek Towards Top Mid,JACKZ,1,0,1,100,95,5,CT,59
5341,Lane Peek Towards Top Mid,JACKZ,0,0,0,0,0,0,T,59
5342,B Site Cross for T's Exposed to CT and Quad,JACKZ,1,0,1,48,0,48,CT,59
5343,B Site Cross for T's Exposed to CT and Quad,JACKZ,0,1,-1,0,100,-100,T,59
5344,Top Graveyard,JACKZ,0,0,0,0,0,0,CT,59
5345,Top Graveyard,JACKZ,0,0,0,0,0,0,T,59
5346,Top Hay Bales,JACKZ,0,0,0,0,0,0,CT,59
5347,Top Hay Bales,JACKZ,0,1,-1,0,100,-100,T,59
5348,CT Banana Sandbags Right Corner,JACKZ,0,0,0,0,0,0,CT,59
5349,CT Banana Sandbags Right Corner,JACKZ,1,0,1,100,0,100,T,59
5350,A Site Behind Default Boxes,JACKZ,1,0,1,71,0,71,CT,59
5351,A Site Behind Default Boxes,JACKZ,0,0,0,0,0,0,T,59
5352,Chokepoint Entering B,JACKZ,0,0,0,0,19,-19,CT,59
5353,Chokepoint Entering B,JACKZ,1,1,0,57,94,-37,T,59
5354,Arch Side,JACKZ,0,0,0,0,0,0,CT,59
5355,Arch Side,JACKZ,0,0,0,0,29,-29,T,59
5356,BombsiteB,JACKZ,0,0,0,0,0,0,CT,59
5357,BombsiteB,JACKZ,0,1,-1,0,4,-4,T,59
5358,Deep CT Peeking Towards B Site,JACKZ,0,1,-1,34,32,2,CT,59
5359,Deep CT Peeking Towards B Site,JACKZ,0,0,0,0,0,0,T,59
5360,Pit Peek Towards Lane,JACKZ,3,1,2,300,191,109,CT,59
5361,Pit Peek Towards Lane,JACKZ,0,0,0,0,0,0,T,59
5362,CT Arch,JACKZ,0,1,-1,0,81,-81,CT,59
5363,CT Arch,JACKZ,0,0,0,0,0,0,T,59
5364,Middle,JACKZ,2,1,1,200,100,100,CT,59
5365,Middle,JACKZ,0,0,0,0,25,-25,T,59
5366,Behind Coffins Playing the B Site Cross,JACKZ,0,0,0,0,0,0,CT,59
5367,Behind Coffins Playing the B Site Cross,JACKZ,0,0,0,0,0,0,T,59
5368,Lane Side,cadiaN,1,2,-1,100,200,-100,CT,65
5369,Lane Side,cadiaN,2,1,1,47,80,-33,T,65
5370,Top Mid Lane Side ,cadiaN,3,2,1,441,200,241,CT,65
5371,Top Mid Lane Side ,cadiaN,0,0,0,8,0,8,T,65
5372,CT Banana Half Wall Side,cadiaN,1,0,1,45,62,-17,CT,65
5373,CT Banana Half Wall Side,cadiaN,0,3,-3,202,215,-13,T,65
5374,Banana,cadiaN,0,0,0,0,0,0,CT,65
5375,Banana,cadiaN,1,0,1,153,94,59,T,65
5376,A Bombsite Close Left,cadiaN,0,1,-1,20,53,-33,CT,65
5377,A Bombsite Close Left,cadiaN,0,0,0,0,0,0,T,65
5378,Deep Apps Past Hallway,cadiaN,1,1,0,100,100,0,CT,65
5379,Deep Apps Past Hallway,cadiaN,0,1,-1,0,72,-72,T,65
5380,Chokepoint Entrance onto A site from Library Side,cadiaN,1,2,-1,100,200,-100,CT,65
5381,Chokepoint Entrance onto A site from Library Side,cadiaN,1,1,0,47,100,-53,T,65
5382,CT Spawn ,cadiaN,0,0,0,0,0,0,CT,65
5383,CT Spawn ,cadiaN,0,0,0,0,0,0,T,65
5384,Top Coffins,cadiaN,0,1,-1,100,100,0,CT,65
5385,Top Coffins,cadiaN,0,1,-1,12,76,-64,T,65
5386,A Site,cadiaN,3,1,2,164,38,126,CT,65
5387,A Site,cadiaN,1,0,1,120,42,78,T,65
5388,B Site Cross for T's Exposed to CT and Quad,cadiaN,0,1,-1,15,100,-85,CT,65
5389,B Site Cross for T's Exposed to CT and Quad,cadiaN,0,0,0,0,0,0,T,65
5390,A Site Behind Default Boxes,cadiaN,0,1,-1,0,100,-100,CT,65
5391,A Site Behind Default Boxes,cadiaN,0,0,0,0,0,0,T,65
5392,Behind Coffins Playing the B Site Cross,cadiaN,0,0,0,0,0,0,CT,65
5393,Behind Coffins Playing the B Site Cross,cadiaN,0,0,0,0,0,0,T,65
5394,Right Side Quadbox Peek for a CT,cadiaN,1,1,0,72,91,-19,CT,65
5395,Right Side Quadbox Peek for a CT,cadiaN,0,0,0,0,0,0,T,65
5396,Underpass,cadiaN,0,0,0,0,0,0,CT,65
5397,Underpass,cadiaN,0,0,0,0,71,-71,T,65
5398,Logs,cadiaN,0,0,0,0,0,0,CT,65
5399,Logs,cadiaN,0,1,-1,3,81,-78,T,65
5400,T Ramp Peeking Towards Mid,cadiaN,0,0,0,0,0,0,CT,65
5401,T Ramp Peeking Towards Mid,cadiaN,0,1,-1,0,128,-128,T,65
5402,CT Arch,cadiaN,1,0,1,23,0,23,CT,65
5403,CT Arch,cadiaN,0,1,-1,0,100,-100,T,65
5404,A Site Behind Middle Boxes/Pillar hidden from Lane,cadiaN,0,0,0,0,0,0,CT,65
5405,A Site Behind Middle Boxes/Pillar hidden from Lane,cadiaN,0,0,0,0,0,0,T,65
5406,Arch Side,cadiaN,2,1,1,206,140,66,CT,65
5407,Arch Side,cadiaN,1,0,1,151,91,60,T,65
5408,Top Mid Arch Side,cadiaN,2,1,1,245,29,216,CT,65
5409,Top Mid Arch Side,cadiaN,0,0,0,0,0,0,T,65
5410,Pit Below Balcony,cadiaN,0,0,0,0,0,0,CT,65
5411,Pit Below Balcony,cadiaN,0,1,-1,0,100,-100,T,65
5412,Chokepoint Entering B,cadiaN,4,1,3,390,144,246,CT,65
5413,Chokepoint Entering B,cadiaN,0,1,-1,15,211,-196,T,65
5414,Top Balcony ,cadiaN,0,0,0,2,0,2,CT,65
5415,Top Balcony ,cadiaN,0,0,0,0,0,0,T,65
5416,Boiler Room,cadiaN,0,0,0,0,0,0,CT,65
5417,Boiler Room,cadiaN,0,0,0,0,0,0,T,65
5418,Deep CT Peeking Towards B Site,cadiaN,0,0,0,8,0,8,CT,65
5419,Deep CT Peeking Towards B Site,cadiaN,1,1,0,112,180,-68,T,65
5420,A Bombsite Back Site,cadiaN,1,0,1,82,0,82,CT,65
5421,A Bombsite Back Site,cadiaN,0,0,0,0,0,0,T,65
5422,CT Banana Sandbangs,cadiaN,0,0,0,68,0,68,CT,65
5423,CT Banana Sandbangs,cadiaN,0,0,0,35,55,-20,T,65
5424,A Site Left Side Middle Boxes,cadiaN,1,0,1,99,0,99,CT,65
5425,A Site Left Side Middle Boxes,cadiaN,0,1,-1,0,100,-100,T,65
5426,Bottom Mid Banana,cadiaN,0,0,0,0,0,0,CT,65
5427,Bottom Mid Banana,cadiaN,1,1,0,63,209,-146,T,65
5428,CT Outside Kitchen,cadiaN,0,0,0,0,0,0,CT,65
5429,CT Outside Kitchen,cadiaN,0,0,0,0,0,0,T,65
5430,Apps Hallway,cadiaN,0,0,0,0,0,0,CT,65
5431,Apps Hallway,cadiaN,0,0,0,0,0,0,T,65
5432,2nd Oranges,cadiaN,0,0,0,0,0,0,CT,65
5433,2nd Oranges,cadiaN,0,0,0,0,0,0,T,65
5434,TSpawn,cadiaN,0,0,0,0,0,0,CT,65
5435,TSpawn,cadiaN,0,1,-1,0,62,-62,T,65
5436,CT Outside Arch,cadiaN,0,0,0,0,0,0,CT,65
5437,CT Outside Arch,cadiaN,2,0,2,200,0,200,T,65
5438,Bottom Mid exposed to Top Mid,cadiaN,0,0,0,0,0,0,CT,65
5439,Bottom Mid exposed to Top Mid,cadiaN,0,0,0,0,0,0,T,65
5440,CT Outside Construction,cadiaN,2,1,1,285,100,185,CT,65
5441,CT Outside Construction,cadiaN,0,0,0,0,0,0,T,65
5442,TRamp,cadiaN,1,1,0,0,0,0,CT,65
5443,TRamp,cadiaN,0,0,0,0,0,0,T,65
5444,Boiler Side Stairs,cadiaN,0,0,0,0,17,-17,CT,65
5445,Boiler Side Stairs,cadiaN,0,1,-1,0,56,-56,T,65
5446,Apartments Hallway Peek from T Side,cadiaN,0,0,0,0,87,-87,CT,65
5447,Apartments Hallway Peek from T Side,cadiaN,0,0,0,0,0,0,T,65
5448,CT Peek Towards B Choke,cadiaN,0,0,0,0,0,0,CT,65
5449,CT Peek Towards B Choke,cadiaN,0,1,-1,0,38,-38,T,65
5450,Banana,rain,4,1,3,324,158,166,CT,74
5451,Banana,rain,1,3,-2,281,385,-104,T,74
5452,Chokepoint Entering B,rain,1,1,0,188,63,125,CT,74
5453,Chokepoint Entering B,rain,0,1,-1,248,112,136,T,74
5454,CT Banana Sandbangs,rain,2,1,1,369,166,203,CT,74
5455,CT Banana Sandbangs,rain,0,1,-1,0,85,-85,T,74
5456,Behind Coffins Playing the B Site Cross,rain,1,1,0,116,100,16,CT,74
5457,Behind Coffins Playing the B Site Cross,rain,0,0,0,0,21,-21,T,74
5458,B Site,rain,1,1,0,97,100,-3,CT,74
5459,B Site,rain,4,2,2,376,193,183,T,74
5460,Lane Side,rain,2,2,0,264,188,76,CT,74
5461,Lane Side,rain,2,0,2,88,0,88,T,74
5462,Top Mid Arch Side,rain,0,0,0,0,0,0,CT,74
5463,Top Mid Arch Side,rain,2,2,0,117,188,-71,T,74
5464,CT Banana Half Wall Side,rain,1,2,-1,242,322,-80,CT,74
5465,CT Banana Half Wall Side,rain,1,0,1,111,141,-30,T,74
5466,Top Mid Chokepoint,rain,0,0,0,0,0,0,CT,74
5467,Top Mid Chokepoint,rain,0,2,-2,84,321,-237,T,74
5468,Arch Side,rain,0,1,-1,0,100,-100,CT,74
5469,Arch Side,rain,1,0,1,19,98,-79,T,74
5470,CT Banana Barrels,rain,2,1,1,262,99,163,CT,74
5471,CT Banana Barrels,rain,1,0,1,100,0,100,T,74
5472,Quad Box,rain,0,1,-1,27,83,-56,CT,74
5473,Quad Box,rain,0,0,0,0,0,0,T,74
5474,Top Mid Lane Side ,rain,1,0,1,100,38,62,CT,74
5475,Top Mid Lane Side ,rain,0,2,-2,27,188,-161,T,74
5476,A Site Behind Default Boxes,rain,0,0,0,0,0,0,CT,74
5477,A Site Behind Default Boxes,rain,1,1,0,100,159,-59,T,74
5478,Bottom Mid exposed to Top Mid,rain,1,0,1,100,26,74,CT,74
5479,Bottom Mid exposed to Top Mid,rain,0,0,0,66,0,66,T,74
5480,Bottom Mid Banana,rain,0,0,0,0,0,0,CT,74
5481,Bottom Mid Banana,rain,0,0,0,5,18,-13,T,74
5482,Chokepoint Entrance onto A site from Library Side,rain,0,0,0,0,0,0,CT,74
5483,Chokepoint Entrance onto A site from Library Side,rain,0,0,0,0,0,0,T,74
5484,Dark,rain,0,0,0,0,0,0,CT,74
5485,Dark,rain,0,1,-1,0,64,-64,T,74
5486,Grill,rain,0,0,0,0,0,0,CT,74
5487,Grill,rain,0,1,-1,0,139,-139,T,74
5488,Top Hay Bales,rain,0,1,-1,22,74,-52,CT,74
5489,Top Hay Bales,rain,0,0,0,0,0,0,T,74
5490,CT Near Well,rain,0,1,-1,9,100,-91,CT,74
5491,CT Near Well,rain,0,0,0,0,0,0,T,74
5492,Next to Library Cubby,rain,0,0,0,0,0,0,CT,74
5493,Next to Library Cubby,rain,0,1,-1,60,84,-24,T,74
5494,A Bombsite Back Site,rain,0,0,0,0,0,0,CT,74
5495,A Bombsite Back Site,rain,0,1,-1,0,12,-12,T,74
5496,TRamp,rain,0,0,0,0,0,0,CT,74
5497,TRamp,rain,0,1,-1,0,37,-37,T,74
5498,Outside Library,rain,2,0,2,232,33,199,CT,74
5499,Outside Library,rain,0,1,-1,0,65,-65,T,74
5500,A Site,rain,0,0,0,0,0,0,CT,74
5501,A Site,rain,0,0,0,27,0,27,T,74
5502,CT Arch,rain,0,0,0,0,0,0,CT,74
5503,CT Arch,rain,0,0,0,0,0,0,T,74
5504,Deep CT Peeking Towards B Site,rain,0,0,0,0,0,0,CT,74
5505,Deep CT Peeking Towards B Site,rain,0,1,-1,0,100,-100,T,74
5506,Lane Patio,rain,0,0,0,0,0,0,CT,74
5507,Lane Patio,rain,0,0,0,0,0,0,T,74
5508,Logs,rain,0,0,0,50,0,50,CT,74
5509,Logs,rain,1,1,0,138,115,23,T,74
5510,Lane Peek Towards Top Mid,rain,0,1,-1,48,95,-47,CT,74
5511,Lane Peek Towards Top Mid,rain,0,0,0,0,0,0,T,74
5512,CT Banana Close Left Half Wall,rain,0,0,0,94,68,26,CT,74
5513,CT Banana Close Left Half Wall,rain,0,0,0,0,0,0,T,74
5514,T Apps,rain,0,0,0,0,0,0,CT,74
5515,T Apps,rain,0,1,-1,0,12,-12,T,74
5516,Pit Peek Towards Lane,rain,0,0,0,0,0,0,CT,74
5517,Pit Peek Towards Lane,rain,0,0,0,0,0,0,T,74
5518,Boiler Peek to Mid,rain,0,0,0,0,0,0,CT,74
5519,Boiler Peek to Mid,rain,0,0,0,0,39,-39,T,74
5520,CT Peek Towards B Choke,rain,1,1,0,142,86,56,CT,74
5521,CT Peek Towards B Choke,rain,0,0,0,0,0,0,T,74
5522,A Site Right Side Middle Pillar,rain,0,0,0,0,0,0,CT,74
5523,A Site Right Side Middle Pillar,rain,0,0,0,0,0,0,T,74
5524,SecondMid,rain,0,0,0,0,0,0,CT,74
5525,SecondMid,rain,0,1,-1,26,118,-92,T,74
5526,CT Banana Sandbags Right Corner,rain,0,0,0,0,0,0,CT,74
5527,CT Banana Sandbags Right Corner,rain,0,1,-1,0,99,-99,T,74
5528,Middle,rain,0,0,0,0,0,0,CT,74
5529,Middle,rain,0,1,-1,9,107,-98,T,74
5530,Right Side Quadbox Peek for a CT,rain,0,0,0,0,0,0,CT,74
5531,Right Side Quadbox Peek for a CT,rain,0,0,0,0,0,0,T,74
5532,Top Coffins,rain,2,1,1,221,44,177,CT,74
5533,Top Coffins,rain,1,0,1,100,0,100,T,74
5534,Pit,rain,0,0,0,0,0,0,CT,74
5535,Pit,rain,0,0,0,0,0,0,T,74
5536,A Bombsite Close Left,rain,0,0,0,0,0,0,CT,74
5537,A Bombsite Close Left,rain,0,1,-1,0,119,-119,T,74
5538,Library,rain,0,0,0,0,52,-52,CT,74
5539,Library,rain,1,0,1,100,0,100,T,74
5540,BPlatform,rain,0,0,0,0,0,0,CT,74
5541,BPlatform,rain,0,1,-1,0,51,-51,T,74
5542,Deep CT Peeking Towards B Site,KRIMZ,4,4,0,363,364,-1,CT,48
5543,Deep CT Peeking Towards B Site,KRIMZ,0,0,0,0,0,0,T,48
5544,B Site Cross for T's Exposed to CT and Quad,KRIMZ,1,0,1,80,60,20,CT,48
5545,B Site Cross for T's Exposed to CT and Quad,KRIMZ,0,1,-1,0,71,-71,T,48
5546,Arch Side,KRIMZ,1,3,-2,279,313,-34,CT,48
5547,Arch Side,KRIMZ,0,0,0,0,0,0,T,48
5548,Library,KRIMZ,1,2,-1,116,200,-84,CT,48
5549,Library,KRIMZ,0,1,-1,0,12,-12,T,48
5550,CT Banana Half Wall Side,KRIMZ,0,0,0,0,0,0,CT,48
5551,CT Banana Half Wall Side,KRIMZ,0,2,-2,86,194,-108,T,48
5552,Top Mid Chokepoint,KRIMZ,0,1,-1,40,87,-47,CT,48
5553,Top Mid Chokepoint,KRIMZ,0,1,-1,0,6,-6,T,48
5554,CT Banana Sandbangs,KRIMZ,0,0,0,29,0,29,CT,48
5555,CT Banana Sandbangs,KRIMZ,0,0,0,0,0,0,T,48
5556,Lane Side,KRIMZ,1,1,0,62,100,-38,CT,48
5557,Lane Side,KRIMZ,1,1,0,62,73,-11,T,48
5558,Top Mid Lane Side ,KRIMZ,2,0,2,199,1,198,CT,48
5559,Top Mid Lane Side ,KRIMZ,1,1,0,159,95,64,T,48
5560,CT Peek Towards B Choke,KRIMZ,2,0,2,165,81,84,CT,48
5561,CT Peek Towards B Choke,KRIMZ,0,0,0,0,0,0,T,48
5562,Middle,KRIMZ,1,1,0,39,100,-61,CT,48
5563,Middle,KRIMZ,0,1,-1,0,75,-75,T,48
5564,Deep Apps Past Hallway,KRIMZ,0,0,0,0,0,0,CT,48
5565,Deep Apps Past Hallway,KRIMZ,0,0,0,0,0,0,T,48
5566,A Bombsite Close Left,KRIMZ,0,0,0,0,0,0,CT,48
5567,A Bombsite Close Left,KRIMZ,0,1,-1,17,100,-83,T,48
5568,Behind Coffins Playing the B Site Cross,KRIMZ,2,1,1,363,100,263,CT,48
5569,Behind Coffins Playing the B Site Cross,KRIMZ,1,0,1,100,16,84,T,48
5570,A Site,KRIMZ,0,1,-1,0,100,-100,CT,48
5571,A Site,KRIMZ,0,0,0,0,0,0,T,48
5572,Underpass,KRIMZ,0,0,0,0,48,-48,CT,48
5573,Underpass,KRIMZ,0,0,0,0,94,-94,T,48
5574,Construction,KRIMZ,0,0,0,0,0,0,CT,48
5575,Construction,KRIMZ,0,0,0,0,0,0,T,48
5576,B Site,KRIMZ,0,0,0,0,0,0,CT,48
5577,B Site,KRIMZ,1,0,1,18,22,-4,T,48
5578,Boiler Peek to Mid,KRIMZ,0,0,0,0,0,0,CT,48
5579,Boiler Peek to Mid,KRIMZ,0,1,-1,0,100,-100,T,48
5580,Apartments Hallway Peek from T Side,KRIMZ,0,1,-1,0,100,-100,CT,48
5581,Apartments Hallway Peek from T Side,KRIMZ,0,0,0,0,0,0,T,48
5582,CT Banana Barrels,KRIMZ,0,0,0,0,0,0,CT,48
5583,CT Banana Barrels,KRIMZ,0,0,0,0,0,0,T,48
5584,1st Oranges,KRIMZ,0,1,-1,0,40,-40,CT,48
5585,1st Oranges,KRIMZ,0,0,0,0,0,0,T,48
5586,Pit Peek Towards Lane,KRIMZ,0,0,0,0,0,0,CT,48
5587,Pit Peek Towards Lane,KRIMZ,1,1,0,17,40,-23,T,48
5588,Grill,KRIMZ,0,0,0,0,0,0,CT,48
5589,Grill,KRIMZ,0,0,0,0,0,0,T,48
5590,Top Mid Arch Side,KRIMZ,0,0,0,27,0,27,CT,48
5591,Top Mid Arch Side,KRIMZ,1,0,1,86,36,50,T,48
5592,Back Alley,KRIMZ,0,0,0,0,0,0,CT,48
5593,Back Alley,KRIMZ,0,1,-1,27,100,-73,T,48
5594,Logs,KRIMZ,0,0,0,0,0,0,CT,48
5595,Logs,KRIMZ,0,0,0,0,0,0,T,48
5596,Bottom Mid exposed to Top Mid,KRIMZ,0,0,0,0,0,0,CT,48
5597,Bottom Mid exposed to Top Mid,KRIMZ,0,1,-1,0,100,-100,T,48
5598,2nd Oranges,KRIMZ,0,0,0,0,0,0,CT,48
5599,2nd Oranges,KRIMZ,0,1,-1,0,100,-100,T,48
5600,Apps T Side Stairs,KRIMZ,0,0,0,0,0,0,CT,48
5601,Apps T Side Stairs,KRIMZ,1,0,1,132,0,132,T,48
5602,Arch Side Cubby,KRIMZ,1,1,0,178,87,91,CT,48
5603,Arch Side Cubby,KRIMZ,1,0,1,100,27,73,T,48
5604,Front Coffins,KRIMZ,0,0,0,0,0,0,CT,48
5605,Front Coffins,KRIMZ,0,1,-1,54,100,-46,T,48
5606,Top Balcony ,KRIMZ,0,0,0,0,0,0,CT,48
5607,Top Balcony ,KRIMZ,0,0,0,0,0,0,T,48
5608,Chokepoint Entering B,KRIMZ,3,0,3,327,60,267,CT,48
5609,Chokepoint Entering B,KRIMZ,2,0,2,200,0,200,T,48
5610,T Apps Bridge ,KRIMZ,0,0,0,0,0,0,CT,48
5611,T Apps Bridge ,KRIMZ,0,0,0,0,0,0,T,48
5612,CT Outside Construction,KRIMZ,0,1,-1,122,100,22,CT,48
5613,CT Outside Construction,KRIMZ,0,0,0,0,0,0,T,48
5614,CT Speed Way,KRIMZ,0,1,-1,0,100,-100,CT,48
5615,CT Speed Way,KRIMZ,1,0,1,0,0,0,T,48
5616,CT Spawn ,KRIMZ,0,1,-1,54,100,-46,CT,48
5617,CT Spawn ,KRIMZ,0,0,0,0,0,0,T,48
5618,CTSideUpper,KRIMZ,0,1,-1,0,7,-7,CT,48
5619,CTSideUpper,KRIMZ,0,0,0,0,0,0,T,48
5620,CT Banana Half Wall Side,frozen,1,0,1,168,71,97,CT,51
5621,CT Banana Half Wall Side,frozen,0,0,0,0,0,0,T,51
5622,Chokepoint Entering B,frozen,2,0,2,146,191,-45,CT,51
5623,Chokepoint Entering B,frozen,0,1,-1,0,133,-133,T,51
5624,A Bombsite Close Left,frozen,0,0,0,0,0,0,CT,51
5625,A Bombsite Close Left,frozen,0,1,-1,0,16,-16,T,51
5626,Banana,frozen,0,0,0,0,6,-6,CT,51
5627,Banana,frozen,1,1,0,87,103,-16,T,51
5628,CT Peek Towards B Choke,frozen,4,1,3,374,187,187,CT,51
5629,CT Peek Towards B Choke,frozen,1,1,0,110,100,10,T,51
5630,Quad Box,frozen,0,2,-2,0,107,-107,CT,51
5631,Quad Box,frozen,0,0,0,0,0,0,T,51
5632,Logs,frozen,0,0,0,0,0,0,CT,51
5633,Logs,frozen,0,1,-1,0,97,-97,T,51
5634,Middle,frozen,1,2,-1,196,213,-17,CT,51
5635,Middle,frozen,0,0,0,10,83,-73,T,51
5636,Pit Below Balcony,frozen,0,0,0,0,0,0,CT,51
5637,Pit Below Balcony,frozen,0,0,0,0,0,0,T,51
5638,Construction,frozen,0,1,-1,0,100,-100,CT,51
5639,Construction,frozen,0,0,0,0,0,0,T,51
5640,Top Mid Arch Side,frozen,0,1,-1,14,100,-86,CT,51
5641,Top Mid Arch Side,frozen,1,1,0,126,127,-1,T,51
5642,CT Tree,frozen,0,1,-1,0,19,-19,CT,51
5643,CT Tree,frozen,0,1,-1,0,100,-100,T,51
5644,CT Banana Sandbangs,frozen,2,2,0,294,227,67,CT,51
5645,CT Banana Sandbangs,frozen,0,0,0,0,0,0,T,51
5646,Lane Side,frozen,1,0,1,18,0,18,CT,51
5647,Lane Side,frozen,0,1,-1,139,100,39,T,51
5648,Lane Peek Towards Top Mid,frozen,0,0,0,0,0,0,CT,51
5649,Lane Peek Towards Top Mid,frozen,0,0,0,0,0,0,T,51
5650,Top Mid Lane Side ,frozen,0,0,0,0,0,0,CT,51
5651,Top Mid Lane Side ,frozen,0,0,0,24,6,18,T,51
5652,Apps T Side Stairs,frozen,0,0,0,0,0,0,CT,51
5653,Apps T Side Stairs,frozen,0,0,0,0,0,0,T,51
5654,Default Plant A Site,frozen,0,0,0,0,0,0,CT,51
5655,Default Plant A Site,frozen,0,1,-1,54,66,-12,T,51
5656,Lane Patio,frozen,0,1,-1,0,51,-51,CT,51
5657,Lane Patio,frozen,0,0,0,0,0,0,T,51
5658,Boiler Peek to Mid,frozen,0,0,0,0,0,0,CT,51
5659,Boiler Peek to Mid,frozen,0,1,-1,31,100,-69,T,51
5660,Dark,frozen,0,0,0,0,0,0,CT,51
5661,Dark,frozen,0,1,-1,24,10,14,T,51
5662,Pit Peek Towards Lane,frozen,0,0,0,0,0,0,CT,51
5663,Pit Peek Towards Lane,frozen,2,0,2,162,59,103,T,51
5664,Chokepoint Entrance onto A site from Library Side,frozen,0,1,-1,0,60,-60,CT,51
5665,Chokepoint Entrance onto A site from Library Side,frozen,0,0,0,0,0,0,T,51
5666,Deep Apps Past Hallway,frozen,0,0,0,20,0,20,CT,51
5667,Deep Apps Past Hallway,frozen,0,1,-1,0,100,-100,T,51
5668,B Site,frozen,0,0,0,3,0,3,CT,51
5669,B Site,frozen,0,1,-1,11,50,-39,T,51
5670,Bottom Mid exposed to Top Mid,frozen,0,0,0,0,0,0,CT,51
5671,Bottom Mid exposed to Top Mid,frozen,1,1,0,149,145,4,T,51
5672,Deep CT Peeking Towards B Site,frozen,0,0,0,27,0,27,CT,51
5673,Deep CT Peeking Towards B Site,frozen,0,0,0,0,0,0,T,51
5674,Library,frozen,0,0,0,0,0,0,CT,51
5675,Library,frozen,0,0,0,0,8,-8,T,51
5676,Outside Library,frozen,0,1,-1,33,100,-67,CT,51
5677,Outside Library,frozen,0,0,0,0,0,0,T,51
5678,Top Coffins,frozen,0,0,0,0,0,0,CT,51
5679,Top Coffins,frozen,0,0,0,1,0,1,T,51
5680,Top Graveyard,frozen,0,1,-1,0,27,-27,CT,51
5681,Top Graveyard,frozen,0,0,0,0,0,0,T,51
5682,Top Mid Chokepoint,frozen,1,0,1,100,0,100,CT,51
5683,Top Mid Chokepoint,frozen,1,1,0,12,157,-145,T,51
5684,Boiler Side Stairs,frozen,0,1,-1,0,87,-87,CT,51
5685,Boiler Side Stairs,frozen,3,0,3,270,48,222,T,51
5686,SecondMid,frozen,0,0,0,0,0,0,CT,51
5687,SecondMid,frozen,1,0,1,105,47,58,T,51
5688,1st Oranges,frozen,0,1,-1,45,100,-55,CT,51
5689,1st Oranges,frozen,0,0,0,0,0,0,T,51
5690,T Ramp Ledge,frozen,0,0,0,0,0,0,CT,51
5691,T Ramp Ledge,frozen,0,0,0,0,0,0,T,51
5692,Top Balcony ,frozen,0,1,-1,0,100,-100,CT,51
5693,Top Balcony ,frozen,2,0,2,27,0,27,T,51
5694,CT Outside Construction,frozen,0,0,0,0,0,0,CT,51
5695,CT Outside Construction,frozen,1,1,0,100,100,0,T,51
5696,A Bombsite Back Site,frozen,0,0,0,0,0,0,CT,51
5697,A Bombsite Back Site,frozen,0,0,0,0,0,0,T,51
5698,T Ramp Peeking Towards Mid,frozen,0,0,0,0,0,0,CT,51
5699,T Ramp Peeking Towards Mid,frozen,0,0,0,0,0,0,T,51
5700,A Bombsite Close Left,RUSH,6,3,3,572,300,272,CT,54
5701,A Bombsite Close Left,RUSH,1,0,1,100,40,60,T,54
5702,Lane Side,RUSH,4,0,4,326,80,246,CT,54
5703,Lane Side,RUSH,1,1,0,100,157,-57,T,54
5704,CT Banana Half Wall Side,RUSH,0,1,-1,0,12,-12,CT,54
5705,CT Banana Half Wall Side,RUSH,0,4,-4,131,365,-234,T,54
5706,Banana,RUSH,0,0,0,0,0,0,CT,54
5707,Banana,RUSH,3,2,1,376,246,130,T,54
5708,Top Mid Lane Side ,RUSH,0,1,-1,0,82,-82,CT,54
5709,Top Mid Lane Side ,RUSH,0,1,-1,0,100,-100,T,54
5710,B Site,RUSH,1,0,1,53,22,31,CT,54
5711,B Site,RUSH,1,2,-1,154,191,-37,T,54
5712,A Site Behind Middle Boxes/Pillar hidden from Lane,RUSH,0,1,-1,78,109,-31,CT,54
5713,A Site Behind Middle Boxes/Pillar hidden from Lane,RUSH,0,0,0,0,0,0,T,54
5714,A Site,RUSH,0,0,0,24,0,24,CT,54
5715,A Site,RUSH,0,1,-1,0,52,-52,T,54
5716,Top Balcony ,RUSH,0,0,0,0,0,0,CT,54
5717,Top Balcony ,RUSH,1,1,0,100,115,-15,T,54
5718,CT Peek Towards B Choke,RUSH,0,2,-2,35,170,-135,CT,54
5719,CT Peek Towards B Choke,RUSH,0,1,-1,0,96,-96,T,54
5720,Default Plant A Site,RUSH,0,0,0,0,0,0,CT,54
5721,Default Plant A Site,RUSH,2,2,0,24,134,-110,T,54
5722,B Site Cross for T's Exposed to CT and Quad,RUSH,0,0,0,0,0,0,CT,54
5723,B Site Cross for T's Exposed to CT and Quad,RUSH,1,2,-1,100,78,22,T,54
5724,Pit Peek Towards Lane,RUSH,1,2,-1,122,184,-62,CT,54
5725,Pit Peek Towards Lane,RUSH,0,0,0,0,0,0,T,54
5726,Arch Side,RUSH,0,0,0,1,0,1,CT,54
5727,Arch Side,RUSH,0,0,0,0,0,0,T,54
5728,Middle,RUSH,0,1,-1,59,100,-41,CT,54
5729,Middle,RUSH,0,0,0,0,59,-59,T,54
5730,A Site Right Side Middle Pillar,RUSH,0,0,0,0,0,0,CT,54
5731,A Site Right Side Middle Pillar,RUSH,1,1,0,100,90,10,T,54
5732,A Bombsite Back Site,RUSH,1,0,1,1,0,1,CT,54
5733,A Bombsite Back Site,RUSH,1,0,1,111,0,111,T,54
5734,Quad Box,RUSH,0,0,0,0,0,0,CT,54
5735,Quad Box,RUSH,0,0,0,0,3,-3,T,54
5736,Pit,RUSH,0,0,0,0,0,0,CT,54
5737,Pit,RUSH,0,1,-1,3,100,-97,T,54
5738,Pit Below Balcony,RUSH,0,0,0,0,0,0,CT,54
5739,Pit Below Balcony,RUSH,0,0,0,0,0,0,T,54
5740,Top Hay Bales,RUSH,1,0,1,42,0,42,CT,54
5741,Top Hay Bales,RUSH,0,1,-1,133,45,88,T,54
5742,1st Oranges,RUSH,0,0,0,20,0,20,CT,54
5743,1st Oranges,RUSH,0,0,0,0,0,0,T,54
5744,Left Side Quadbox Peek for a CT,RUSH,0,0,0,0,0,0,CT,54
5745,Left Side Quadbox Peek for a CT,RUSH,0,1,-1,0,10,-10,T,54
5746,CT Boost,RUSH,1,1,0,90,100,-10,CT,54
5747,CT Boost,RUSH,0,0,0,0,0,0,T,54
5748,Front Coffins,RUSH,0,0,0,0,0,0,CT,54
5749,Front Coffins,RUSH,0,1,-1,81,50,31,T,54
5750,Logs,RUSH,0,0,0,0,0,0,CT,54
5751,Logs,RUSH,0,0,0,83,0,83,T,54
5752,EastForest,RUSH,0,0,0,0,0,0,CT,54
5753,EastForest,RUSH,0,1,-1,0,55,-55,T,54
5754,Behind Coffins Playing the B Site Cross,RUSH,0,1,-1,35,100,-65,CT,54
5755,Behind Coffins Playing the B Site Cross,RUSH,0,0,0,0,0,0,T,54
5756,Right Side Quadbox Peek for a CT,RUSH,0,0,0,0,0,0,CT,54
5757,Right Side Quadbox Peek for a CT,RUSH,0,1,-1,0,100,-100,T,54
5758,CT Banana Close Left Half Wall,RUSH,0,0,0,0,0,0,CT,54
5759,CT Banana Close Left Half Wall,RUSH,0,0,0,0,0,0,T,54
5760,Deep CT Peeking Towards B Site,RUSH,0,0,0,0,0,0,CT,54
5761,Deep CT Peeking Towards B Site,RUSH,0,0,0,0,0,0,T,54
5762,Library,RUSH,1,0,1,88,0,88,CT,54
5763,Library,RUSH,0,0,0,0,0,0,T,54
5764,Bottom Mid exposed to Top Mid,RUSH,1,1,0,100,118,-18,CT,54
5765,Bottom Mid exposed to Top Mid,RUSH,0,0,0,0,0,0,T,54
5766,Outside Library,RUSH,1,1,0,115,100,15,CT,54
5767,Outside Library,RUSH,0,0,0,0,0,0,T,54
5768,Top Graveyard,RUSH,0,0,0,0,0,0,CT,54
5769,Top Graveyard,RUSH,0,0,0,0,0,0,T,54
5770,Chokepoint Entering B,RUSH,0,0,0,75,34,41,CT,54
5771,Chokepoint Entering B,RUSH,1,0,1,59,188,-129,T,54
5772,Top Mid Chokepoint,RUSH,0,0,0,0,0,0,CT,54
5773,Top Mid Chokepoint,RUSH,0,0,0,0,1,-1,T,54
5774,Boiler Side Stairs,RUSH,0,0,0,0,0,0,CT,54
5775,Boiler Side Stairs,RUSH,0,0,0,91,8,83,T,54
5776,CT Banana Barrels,RUSH,0,0,0,0,0,0,CT,54
5777,CT Banana Barrels,RUSH,0,0,0,0,1,-1,T,54
5778,SecondMid,acoR,0,0,0,0,0,0,CT,51
5779,SecondMid,acoR,0,0,0,0,3,-3,T,51
5780,Top Mid Arch Side,acoR,1,1,0,30,100,-70,CT,51
5781,Top Mid Arch Side,acoR,0,1,-1,0,63,-63,T,51
5782,A Bombsite Close Left,acoR,1,0,1,4,22,-18,CT,51
5783,A Bombsite Close Left,acoR,0,1,-1,0,80,-80,T,51
5784,Chokepoint Entering B,acoR,1,0,1,8,145,-137,CT,51
5785,Chokepoint Entering B,acoR,0,2,-2,29,197,-168,T,51
5786,CT Peek Towards B Choke,acoR,1,2,-1,112,127,-15,CT,51
5787,CT Peek Towards B Choke,acoR,0,0,0,0,0,0,T,51
5788,Apartments,acoR,2,1,1,200,100,100,CT,51
5789,Apartments,acoR,0,0,0,0,0,0,T,51
5790,Banana,acoR,0,0,0,0,0,0,CT,51
5791,Banana,acoR,0,0,0,8,155,-147,T,51
5792,Boiler Peek to Mid,acoR,0,0,0,0,0,0,CT,51
5793,Boiler Peek to Mid,acoR,0,0,0,0,0,0,T,51
5794,Behind Coffins Playing the B Site Cross,acoR,0,1,-1,0,67,-67,CT,51
5795,Behind Coffins Playing the B Site Cross,acoR,0,1,-1,0,100,-100,T,51
5796,Pit,acoR,0,0,0,0,0,0,CT,51
5797,Pit,acoR,0,1,-1,82,64,18,T,51
5798,A Site Behind Default Boxes,acoR,0,1,-1,0,100,-100,CT,51
5799,A Site Behind Default Boxes,acoR,0,0,0,0,0,0,T,51
5800,Boiler Room,acoR,1,1,0,166,100,66,CT,51
5801,Boiler Room,acoR,0,0,0,0,0,0,T,51
5802,CT Tree,acoR,0,1,-1,0,100,-100,CT,51
5803,CT Tree,acoR,0,0,0,0,0,0,T,51
5804,Top Mid Chokepoint,acoR,1,0,1,100,0,100,CT,51
5805,Top Mid Chokepoint,acoR,0,1,-1,0,157,-157,T,51
5806,Middle,acoR,0,0,0,0,0,0,CT,51
5807,Middle,acoR,0,1,-1,0,100,-100,T,51
5808,Top Balcony ,acoR,1,0,1,12,0,12,CT,51
5809,Top Balcony ,acoR,0,0,0,0,23,-23,T,51
5810,CT Banana Sandbangs,acoR,0,0,0,0,0,0,CT,51
5811,CT Banana Sandbangs,acoR,1,2,-1,103,164,-61,T,51
5812,Chokepoint Entrance onto A site from Library Side,acoR,0,2,-2,0,200,-200,CT,51
5813,Chokepoint Entrance onto A site from Library Side,acoR,1,0,1,100,0,100,T,51
5814,Lane Behind Pillar,acoR,0,0,0,0,0,0,CT,51
5815,Lane Behind Pillar,acoR,0,1,-1,0,54,-54,T,51
5816,CT Outside Arch,acoR,0,0,0,0,0,0,CT,51
5817,CT Outside Arch,acoR,1,0,1,73,98,-25,T,51
5818,Grill,acoR,0,0,0,0,0,0,CT,51
5819,Grill,acoR,1,0,1,54,0,54,T,51
5820,Top Mid Lane Side ,acoR,1,0,1,114,56,58,CT,51
5821,Top Mid Lane Side ,acoR,0,0,0,0,0,0,T,51
5822,Arch Side CT Corner Peeking Towards Top Mid,acoR,0,0,0,0,0,0,CT,51
5823,Arch Side CT Corner Peeking Towards Top Mid,acoR,0,1,-1,0,100,-100,T,51
5824,Deep Apps Past Hallway,acoR,0,0,0,0,0,0,CT,51
5825,Deep Apps Past Hallway,acoR,0,0,0,0,0,0,T,51
5826,Graveyard Stairs,acoR,0,0,0,0,0,0,CT,51
5827,Graveyard Stairs,acoR,0,0,0,0,0,0,T,51
5828,CT Banana Barrels,acoR,1,1,0,186,100,86,CT,51
5829,CT Banana Barrels,acoR,0,0,0,0,0,0,T,51
5830,Front Coffins,acoR,0,0,0,0,0,0,CT,51
5831,Front Coffins,acoR,0,0,0,0,0,0,T,51
5832,Next to Library Cubby,acoR,0,0,0,0,0,0,CT,51
5833,Next to Library Cubby,acoR,0,0,0,0,0,0,T,51
5834,B Site,acoR,0,1,-1,0,100,-100,CT,51
5835,B Site,acoR,0,0,0,0,0,0,T,51
5836,Library,acoR,0,1,-1,60,14,46,CT,51
5837,Library,acoR,0,0,0,0,0,0,T,51
5838,Bottom Mid exposed to Top Mid,acoR,0,0,0,0,0,0,CT,51
5839,Bottom Mid exposed to Top Mid,acoR,1,1,0,91,146,-55,T,51
5840,Top Coffins,acoR,0,1,-1,0,100,-100,CT,51
5841,Top Coffins,acoR,0,0,0,0,0,0,T,51
5842,CT Arch,acoR,0,1,-1,49,100,-51,CT,51
5843,CT Arch,acoR,0,0,0,0,0,0,T,51
5844,Bottom Mid Banana,acoR,0,0,0,0,0,0,CT,51
5845,Bottom Mid Banana,acoR,1,1,0,100,171,-71,T,51
5846,1st Oranges,acoR,0,0,0,0,0,0,CT,51
5847,1st Oranges,acoR,0,0,0,0,0,0,T,51
5848,Lane Side,acoR,3,0,3,300,0,300,CT,51
5849,Lane Side,acoR,2,1,1,147,169,-22,T,51
5850,CT Outside Construction,acoR,0,1,-1,0,100,-100,CT,51
5851,CT Outside Construction,acoR,0,0,0,0,0,0,T,51
5852,A Bombsite Back Site,acoR,0,0,0,0,0,0,CT,51
5853,A Bombsite Back Site,acoR,0,0,0,0,0,0,T,51
5854,CT Outside Kitchen,acoR,0,0,0,0,0,0,CT,51
5855,CT Outside Kitchen,acoR,0,0,0,0,0,0,T,51
5856,T Ramp Peeking Towards Mid,acoR,0,0,0,0,0,0,CT,51
5857,T Ramp Peeking Towards Mid,acoR,0,0,0,11,0,11,T,51
5858,Chokepoint Entering B,blameF,0,0,0,68,102,-34,CT,54
5859,Chokepoint Entering B,blameF,2,1,1,172,72,100,T,54
5860,Lane Side,blameF,0,0,0,51,0,51,CT,54
5861,Lane Side,blameF,2,3,-1,213,290,-77,T,54
5862,A Bombsite Close Left,blameF,0,0,0,0,0,0,CT,54
5863,A Bombsite Close Left,blameF,0,2,-2,27,189,-162,T,54
5864,Deep CT Peeking Towards B Site,blameF,0,1,-1,42,100,-58,CT,54
5865,Deep CT Peeking Towards B Site,blameF,0,0,0,0,0,0,T,54
5866,Top Balcony ,blameF,0,1,-1,0,4,-4,CT,54
5867,Top Balcony ,blameF,2,0,2,197,0,197,T,54
5868,A Site,blameF,0,1,-1,0,56,-56,CT,54
5869,A Site,blameF,0,1,-1,0,75,-75,T,54
5870,CT Banana Barrels,blameF,0,1,-1,85,99,-14,CT,54
5871,CT Banana Barrels,blameF,0,0,0,0,0,0,T,54
5872,B Site,blameF,2,0,2,117,33,84,CT,54
5873,B Site,blameF,0,0,0,0,0,0,T,54
5874,Chokepoint Entrance onto A site from Library Side,blameF,1,1,0,7,100,-93,CT,54
5875,Chokepoint Entrance onto A site from Library Side,blameF,0,0,0,0,0,0,T,54
5876,Banana,blameF,0,0,0,0,0,0,CT,54
5877,Banana,blameF,2,1,1,117,100,17,T,54
5878,Bottom Mid exposed to Top Mid,blameF,0,0,0,32,0,32,CT,54
5879,Bottom Mid exposed to Top Mid,blameF,0,0,0,0,0,0,T,54
5880,Top Coffins,blameF,0,0,0,0,0,0,CT,54
5881,Top Coffins,blameF,0,1,-1,0,100,-100,T,54
5882,Top Mid Chokepoint,blameF,0,0,0,0,0,0,CT,54
5883,Top Mid Chokepoint,blameF,1,1,0,141,171,-30,T,54
5884,Front Coffins,blameF,0,0,0,0,0,0,CT,54
5885,Front Coffins,blameF,0,1,-1,0,100,-100,T,54
5886,Top Mid Lane Side ,blameF,1,0,1,85,81,4,CT,54
5887,Top Mid Lane Side ,blameF,1,1,0,109,189,-80,T,54
5888,Dark,blameF,2,1,1,205,100,105,CT,54
5889,Dark,blameF,0,0,0,0,0,0,T,54
5890,Middle,blameF,0,1,-1,0,100,-100,CT,54
5891,Middle,blameF,0,0,0,0,0,0,T,54
5892,Grill,blameF,0,0,0,0,0,0,CT,54
5893,Grill,blameF,1,1,0,100,100,0,T,54
5894,CT Banana Sandbangs,blameF,0,0,0,0,0,0,CT,54
5895,CT Banana Sandbangs,blameF,0,1,-1,0,94,-94,T,54
5896,Pit Peek Towards Lane,blameF,0,0,0,0,0,0,CT,54
5897,Pit Peek Towards Lane,blameF,0,0,0,0,26,-26,T,54
5898,Graveyard Stairs,blameF,0,0,0,0,0,0,CT,54
5899,Graveyard Stairs,blameF,0,0,0,0,0,0,T,54
5900,2nd Oranges,blameF,0,0,0,0,0,0,CT,54
5901,2nd Oranges,blameF,0,0,0,23,33,-10,T,54
5902,Deep Apps Past Hallway,blameF,1,0,1,100,0,100,CT,54
5903,Deep Apps Past Hallway,blameF,1,1,0,32,100,-68,T,54
5904,B Site Cross for T's Exposed to CT and Quad,blameF,0,0,0,76,0,76,CT,54
5905,B Site Cross for T's Exposed to CT and Quad,blameF,1,1,0,99,119,-20,T,54
5906,Default Plant A Site,blameF,0,0,0,0,0,0,CT,54
5907,Default Plant A Site,blameF,0,1,-1,0,52,-52,T,54
5908,Construction,blameF,1,1,0,68,100,-32,CT,54
5909,Construction,blameF,0,0,0,0,0,0,T,54
5910,Back Alley,blameF,1,0,1,22,0,22,CT,54
5911,Back Alley,blameF,0,0,0,0,0,0,T,54
5912,Boiler Peek to Mid,blameF,0,1,-1,0,100,-100,CT,54
5913,Boiler Peek to Mid,blameF,0,0,0,0,0,0,T,54
5914,1st Oranges,blameF,0,1,-1,0,100,-100,CT,54
5915,1st Oranges,blameF,0,0,0,0,0,0,T,54
5916,Behind B Site Back Pillar,blameF,0,1,-1,39,43,-4,CT,54
5917,Behind B Site Back Pillar,blameF,0,0,0,52,0,52,T,54
5918,Lane Patio,blameF,0,0,0,0,0,0,CT,54
5919,Lane Patio,blameF,0,0,0,0,0,0,T,54
5920,Behind Coffins Playing the B Site Cross,blameF,2,0,2,152,41,111,CT,54
5921,Behind Coffins Playing the B Site Cross,blameF,0,0,0,0,0,0,T,54
5922,Right Side Quadbox Peek for a CT,blameF,0,0,0,0,0,0,CT,54
5923,Right Side Quadbox Peek for a CT,blameF,0,0,0,0,0,0,T,54
5924,CT Boost,blameF,0,1,-1,84,78,6,CT,54
5925,CT Boost,blameF,0,0,0,0,0,0,T,54
5926,Left Side Quadbox Peek for a CT,blameF,0,0,0,0,0,0,CT,54
5927,Left Side Quadbox Peek for a CT,blameF,1,1,0,26,21,5,T,54
5928,T Ramp Peeking Towards Mid,blameF,0,0,0,0,0,0,CT,54
5929,T Ramp Peeking Towards Mid,blameF,0,0,0,17,30,-13,T,54
5930,CT Banana Half Wall Side,Spinx,4,8,-4,638,756,-118,CT,64
5931,CT Banana Half Wall Side,Spinx,0,3,-3,0,300,-300,T,64
5932,Logs,Spinx,1,1,0,45,100,-55,CT,64
5933,Logs,Spinx,0,0,0,0,0,0,T,64
5934,Banana,Spinx,3,0,3,300,0,300,CT,64
5935,Banana,Spinx,1,2,-1,180,167,13,T,64
5936,Top Mid Arch Side,Spinx,0,0,0,0,0,0,CT,64
5937,Top Mid Arch Side,Spinx,0,4,-4,22,390,-368,T,64
5938,B Site,Spinx,1,0,1,106,22,84,CT,64
5939,B Site,Spinx,0,0,0,0,0,0,T,64
5940,CT Banana Sandbangs,Spinx,2,2,0,384,260,124,CT,64
5941,CT Banana Sandbangs,Spinx,0,0,0,0,0,0,T,64
5942,2nd Oranges,Spinx,2,3,-1,222,168,54,CT,64
5943,2nd Oranges,Spinx,0,0,0,0,0,0,T,64
5944,Chokepoint Entering B,Spinx,0,2,-2,21,288,-267,CT,64
5945,Chokepoint Entering B,Spinx,0,0,0,69,129,-60,T,64
5946,Quad Box,Spinx,4,3,1,327,283,44,CT,64
5947,Quad Box,Spinx,0,0,0,0,0,0,T,64
5948,CT Banana Barrels,Spinx,2,2,0,285,200,85,CT,64
5949,CT Banana Barrels,Spinx,0,0,0,0,0,0,T,64
5950,SecondMid,Spinx,0,0,0,0,0,0,CT,64
5951,SecondMid,Spinx,0,1,-1,0,100,-100,T,64
5952,Top Graveyard,Spinx,0,1,-1,0,74,-74,CT,64
5953,Top Graveyard,Spinx,0,0,0,0,0,0,T,64
5954,T Ramp Peeking Towards Mid,Spinx,1,0,1,96,0,96,CT,64
5955,T Ramp Peeking Towards Mid,Spinx,1,0,1,74,45,29,T,64
5956,Lane Side,Spinx,0,1,-1,27,100,-73,CT,64
5957,Lane Side,Spinx,0,0,0,11,0,11,T,64
5958,Dark,Spinx,1,1,0,100,100,0,CT,64
5959,Dark,Spinx,0,0,0,0,22,-22,T,64
5960,A Bombsite Close Left,Spinx,0,0,0,0,0,0,CT,64
5961,A Bombsite Close Left,Spinx,0,2,-2,0,200,-200,T,64
5962,CT Banana Close Left Half Wall,Spinx,0,2,-2,0,200,-200,CT,64
5963,CT Banana Close Left Half Wall,Spinx,0,0,0,0,0,0,T,64
5964,T Apps,Spinx,0,1,-1,0,49,-49,CT,64
5965,T Apps,Spinx,0,0,0,0,0,0,T,64
5966,Grill,Spinx,0,0,0,19,36,-17,CT,64
5967,Grill,Spinx,0,0,0,0,0,0,T,64
5968,1st Oranges,Spinx,1,1,0,49,107,-58,CT,64
5969,1st Oranges,Spinx,0,0,0,0,0,0,T,64
5970,Pit Peek Towards Lane,Spinx,0,0,0,0,0,0,CT,64
5971,Pit Peek Towards Lane,Spinx,0,0,0,0,0,0,T,64
5972,Chokepoint Entrance onto A site from Library Side,Spinx,0,1,-1,0,74,-74,CT,64
5973,Chokepoint Entrance onto A site from Library Side,Spinx,0,0,0,0,0,0,T,64
5974,CT Outside Construction,Spinx,0,1,-1,0,37,-37,CT,64
5975,CT Outside Construction,Spinx,0,0,0,0,0,0,T,64
5976,B Site Cross for T's Exposed to CT and Quad,Spinx,0,0,0,0,0,0,CT,64
5977,B Site Cross for T's Exposed to CT and Quad,Spinx,0,1,-1,0,8,-8,T,64
5978,Front Coffins,Spinx,0,0,0,0,0,0,CT,64
5979,Front Coffins,Spinx,0,0,0,0,0,0,T,64
5980,Apartments,Spinx,0,1,-1,0,30,-30,CT,64
5981,Apartments,Spinx,0,0,0,0,0,0,T,64
5982,Behind Coffins Playing the B Site Cross,Spinx,0,1,-1,0,100,-100,CT,64
5983,Behind Coffins Playing the B Site Cross,Spinx,0,0,0,0,0,0,T,64
5984,Deep CT Peeking Towards B Site,Spinx,0,0,0,0,0,0,CT,64
5985,Deep CT Peeking Towards B Site,Spinx,0,0,0,0,0,0,T,64
5986,Library,Spinx,0,0,0,0,27,-27,CT,64
5987,Library,Spinx,0,0,0,0,0,0,T,64
5988,Apps T Side Stairs,Spinx,0,0,0,55,0,55,CT,64
5989,Apps T Side Stairs,Spinx,0,1,-1,0,63,-63,T,64
5990,Top Mid Chokepoint,Spinx,0,0,0,0,0,0,CT,64
5991,Top Mid Chokepoint,Spinx,0,1,-1,0,110,-110,T,64
5992,Boiler Side Stairs,Spinx,0,0,0,0,0,0,CT,64
5993,Boiler Side Stairs,Spinx,0,0,0,0,0,0,T,64
5994,CT Banana Sandbags Right Corner,Spinx,1,0,1,100,29,71,CT,64
5995,CT Banana Sandbags Right Corner,Spinx,0,0,0,0,0,0,T,64
5996,Middle,Spinx,0,0,0,0,22,-22,CT,64
5997,Middle,Spinx,0,0,0,0,0,0,T,64
5998,CT Peek Towards B Choke,Spinx,0,0,0,0,0,0,CT,64
5999,CT Peek Towards B Choke,Spinx,0,1,-1,0,0,0,T,64
6000,Arch Side,Spinx,2,0,2,207,0,207,CT,64
6001,Arch Side,Spinx,1,1,0,60,100,-40,T,64
6002,A Bombsite Back Site,Spinx,0,0,0,0,0,0,CT,64
6003,A Bombsite Back Site,Spinx,0,1,-1,0,100,-100,T,64
6004,CT Speed Way,Spinx,0,1,-1,0,100,-100,CT,64
6005,CT Speed Way,Spinx,0,0,0,0,0,0,T,64
6006,Top Balcony ,sjuush,0,1,-1,73,23,50,CT,65
6007,Top Balcony ,sjuush,0,1,-1,8,145,-137,T,65
6008,Pit Peek Towards Lane,sjuush,1,4,-3,429,473,-44,CT,65
6009,Pit Peek Towards Lane,sjuush,0,0,0,0,0,0,T,65
6010,A Site Behind Middle Boxes/Pillar hidden from Lane,sjuush,0,0,0,0,0,0,CT,65
6011,A Site Behind Middle Boxes/Pillar hidden from Lane,sjuush,0,1,-1,0,100,-100,T,65
6012,Deep Apps Past Hallway,sjuush,0,1,-1,44,100,-56,CT,65
6013,Deep Apps Past Hallway,sjuush,0,0,0,77,0,77,T,65
6014,A Bombsite Close Left,sjuush,0,0,0,0,0,0,CT,65
6015,A Bombsite Close Left,sjuush,0,1,-1,0,2,-2,T,65
6016,Chokepoint Entering B,sjuush,0,1,-1,32,95,-63,CT,65
6017,Chokepoint Entering B,sjuush,1,0,1,100,74,26,T,65
6018,Pit Below Balcony,sjuush,2,2,0,414,233,181,CT,65
6019,Pit Below Balcony,sjuush,0,0,0,0,0,0,T,65
6020,Top Mid Lane Side ,sjuush,1,1,0,117,149,-32,CT,65
6021,Top Mid Lane Side ,sjuush,0,0,0,0,0,0,T,65
6022,Lane Behind Pillar,sjuush,1,1,0,134,100,34,CT,65
6023,Lane Behind Pillar,sjuush,0,1,-1,71,76,-5,T,65
6024,Behind Coffins Playing the B Site Cross,sjuush,0,0,0,0,0,0,CT,65
6025,Behind Coffins Playing the B Site Cross,sjuush,0,1,-1,0,100,-100,T,65
6026,B Site,sjuush,0,0,0,0,0,0,CT,65
6027,B Site,sjuush,0,1,-1,0,74,-74,T,65
6028,Default Plant A Site,sjuush,0,0,0,0,0,0,CT,65
6029,Default Plant A Site,sjuush,0,0,0,0,0,0,T,65
6030,B Site Cross for T's Exposed to CT and Quad,sjuush,0,1,-1,0,77,-77,CT,65
6031,B Site Cross for T's Exposed to CT and Quad,sjuush,0,1,-1,0,72,-72,T,65
6032,CT Banana Half Wall Side,sjuush,0,0,0,0,0,0,CT,65
6033,CT Banana Half Wall Side,sjuush,1,1,0,118,149,-31,T,65
6034,Banana,sjuush,0,1,-1,86,91,-5,CT,65
6035,Banana,sjuush,0,1,-1,26,204,-178,T,65
6036,Lane Side,sjuush,4,1,3,350,147,203,CT,65
6037,Lane Side,sjuush,0,1,-1,0,198,-198,T,65
6038,CT Peek Towards B Choke,sjuush,0,0,0,0,0,0,CT,65
6039,CT Peek Towards B Choke,sjuush,1,1,0,125,100,25,T,65
6040,CT Boost,sjuush,0,1,-1,0,100,-100,CT,65
6041,CT Boost,sjuush,1,1,0,63,100,-37,T,65
6042,CT Outside Construction,sjuush,0,0,0,0,0,0,CT,65
6043,CT Outside Construction,sjuush,0,1,-1,89,1,88,T,65
6044,A Site Left Side Middle Boxes,sjuush,0,0,0,0,0,0,CT,65
6045,A Site Left Side Middle Boxes,sjuush,0,0,0,0,0,0,T,65
6046,2nd Oranges,sjuush,0,0,0,0,0,0,CT,65
6047,2nd Oranges,sjuush,0,0,0,0,0,0,T,65
6048,Pit,sjuush,1,0,1,101,5,96,CT,65
6049,Pit,sjuush,0,0,0,0,0,0,T,65
6050,Construction,sjuush,1,0,1,37,0,37,CT,65
6051,Construction,sjuush,0,1,-1,0,126,-126,T,65
6052,Dark,sjuush,0,0,0,0,0,0,CT,65
6053,Dark,sjuush,0,0,0,8,0,8,T,65
6054,Boiler Peek to Mid,sjuush,0,0,0,13,0,13,CT,65
6055,Boiler Peek to Mid,sjuush,0,0,0,0,0,0,T,65
6056,CT Banana Barrels,sjuush,0,0,0,0,0,0,CT,65
6057,CT Banana Barrels,sjuush,0,0,0,0,0,0,T,65
6058,Underpass,sjuush,1,0,1,100,0,100,CT,65
6059,Underpass,sjuush,0,1,-1,0,100,-100,T,65
6060,CT Arch,sjuush,0,0,0,0,0,0,CT,65
6061,CT Arch,sjuush,0,1,-1,0,216,-216,T,65
6062,Top Hay Bales,sjuush,0,0,0,13,0,13,CT,65
6063,Top Hay Bales,sjuush,0,1,-1,27,29,-2,T,65
6064,Front Coffins,sjuush,0,0,0,0,0,0,CT,65
6065,Front Coffins,sjuush,1,1,0,83,77,6,T,65
6066,Outside Library,sjuush,0,0,0,0,0,0,CT,65
6067,Outside Library,sjuush,0,0,0,0,3,-3,T,65
6068,Library,sjuush,0,0,0,0,0,0,CT,65
6069,Library,sjuush,0,0,0,0,0,0,T,65
6070,CT Banana Sandbangs,sjuush,0,0,0,103,0,103,CT,65
6071,CT Banana Sandbangs,sjuush,1,1,0,73,91,-18,T,65
6072,Bottom Mid exposed to Top Mid,sjuush,1,0,1,42,0,42,CT,65
6073,Bottom Mid exposed to Top Mid,sjuush,0,0,0,0,0,0,T,65
6074,CT Tree,sjuush,0,0,0,0,0,0,CT,65
6075,CT Tree,sjuush,0,0,0,0,0,0,T,65
6076,Apps T Side Stairs,sjuush,0,1,-1,89,100,-11,CT,65
6077,Apps T Side Stairs,sjuush,0,0,0,0,0,0,T,65
6078,Top Mid Chokepoint,sjuush,0,0,0,0,0,0,CT,65
6079,Top Mid Chokepoint,sjuush,0,1,-1,27,37,-10,T,65
6080,Bottom Mid Banana,sjuush,0,0,0,7,0,7,CT,65
6081,Bottom Mid Banana,sjuush,0,0,0,0,0,0,T,65
6082,1st Oranges,sjuush,0,0,0,0,0,0,CT,65
6083,1st Oranges,sjuush,0,0,0,0,0,0,T,65
6084,Middle,sjuush,2,0,2,197,0,197,CT,65
6085,Middle,sjuush,0,0,0,0,0,0,T,65
6086,A Bombsite Back Site,sjuush,1,0,1,100,0,100,CT,65
6087,A Bombsite Back Site,sjuush,1,1,0,178,71,107,T,65
6088,Arch Side,sjuush,0,0,0,0,0,0,CT,65
6089,Arch Side,sjuush,1,1,0,163,134,29,T,65
6090,CT Spawn ,sjuush,0,0,0,0,0,0,CT,65
6091,CT Spawn ,sjuush,0,1,-1,0,11,-11,T,65
6092,2nd Oranges,jks,2,5,-3,264,437,-173,CT,54
6093,2nd Oranges,jks,0,1,-1,74,82,-8,T,54
6094,A Bombsite Back Site,jks,0,0,0,0,0,0,CT,54
6095,A Bombsite Back Site,jks,0,0,0,0,0,0,T,54
6096,Chokepoint Entering B,jks,0,1,-1,100,100,0,CT,54
6097,Chokepoint Entering B,jks,3,2,1,222,218,4,T,54
6098,1st Oranges,jks,0,2,-2,68,200,-132,CT,54
6099,1st Oranges,jks,0,0,0,0,0,0,T,54
6100,Top Balcony ,jks,0,0,0,0,0,0,CT,54
6101,Top Balcony ,jks,1,3,-2,127,300,-173,T,54
6102,CT Peek Towards B Choke,jks,0,1,-1,27,17,10,CT,54
6103,CT Peek Towards B Choke,jks,0,0,0,0,0,0,T,54
6104,Lane Side,jks,1,0,1,63,0,63,CT,54
6105,Lane Side,jks,1,2,-1,39,318,-279,T,54
6106,Top Mid Chokepoint,jks,0,0,0,0,0,0,CT,54
6107,Top Mid Chokepoint,jks,0,2,-2,92,200,-108,T,54
6108,Quad Box,jks,1,1,0,115,131,-16,CT,54
6109,Quad Box,jks,0,0,0,0,0,0,T,54
6110,B Site Cross for T's Exposed to CT and Quad,jks,0,0,0,15,0,15,CT,54
6111,B Site Cross for T's Exposed to CT and Quad,jks,0,1,-1,97,66,31,T,54
6112,Top Graveyard,jks,0,0,0,0,0,0,CT,54
6113,Top Graveyard,jks,2,1,1,199,100,99,T,54
6114,CT Banana Half Wall Side,jks,0,1,-1,31,99,-68,CT,54
6115,CT Banana Half Wall Side,jks,0,1,-1,34,100,-66,T,54
6116,CT Banana Sandbangs,jks,1,0,1,51,103,-52,CT,54
6117,CT Banana Sandbangs,jks,1,1,0,79,100,-21,T,54
6118,Top Mid Lane Side ,jks,0,0,0,0,14,-14,CT,54
6119,Top Mid Lane Side ,jks,0,0,0,0,9,-9,T,54
6120,A Site Behind Middle Boxes/Pillar hidden from Lane,jks,0,0,0,0,0,0,CT,54
6121,A Site Behind Middle Boxes/Pillar hidden from Lane,jks,0,0,0,0,0,0,T,54
6122,Pit Peek Towards Lane,jks,0,0,0,0,0,0,CT,54
6123,Pit Peek Towards Lane,jks,1,1,0,145,100,45,T,54
6124,A Bombsite Close Left,jks,0,0,0,0,0,0,CT,54
6125,A Bombsite Close Left,jks,1,1,0,83,100,-17,T,54
6126,Apartments Hallway Peek from T Side,jks,0,0,0,0,0,0,CT,54
6127,Apartments Hallway Peek from T Side,jks,0,1,-1,0,100,-100,T,54
6128,Deep Apps Past Hallway,jks,0,0,0,0,0,0,CT,54
6129,Deep Apps Past Hallway,jks,2,0,2,173,0,173,T,54
6130,Underpass,jks,0,0,0,0,0,0,CT,54
6131,Underpass,jks,0,1,-1,0,116,-116,T,54
6132,Construction,jks,0,0,0,0,0,0,CT,54
6133,Construction,jks,0,0,0,0,0,0,T,54
6134,B Site,jks,0,0,0,0,0,0,CT,54
6135,B Site,jks,1,0,1,100,18,82,T,54
6136,Grill,jks,0,0,0,0,0,0,CT,54
6137,Grill,jks,2,0,2,145,21,124,T,54
6138,Arch Side,jks,1,0,1,100,0,100,CT,54
6139,Arch Side,jks,0,0,0,0,0,0,T,54
6140,Chokepoint Entrance onto A site from Library Side,jks,1,1,0,100,100,0,CT,54
6141,Chokepoint Entrance onto A site from Library Side,jks,0,0,0,0,0,0,T,54
6142,CT Outside Construction,jks,1,0,1,44,0,44,CT,54
6143,CT Outside Construction,jks,0,0,0,0,0,0,T,54
6144,Left Side Quadbox Peek for a CT,jks,0,1,-1,54,45,9,CT,54
6145,Left Side Quadbox Peek for a CT,jks,0,0,0,0,0,0,T,54
6146,Boiler Side Stairs,jks,0,0,0,0,0,0,CT,54
6147,Boiler Side Stairs,jks,0,0,0,0,0,0,T,54
6148,A Site,jks,2,0,2,125,0,125,CT,54
6149,A Site,jks,0,0,0,0,0,0,T,54
6150,Bottom Mid exposed to Top Mid,jks,0,0,0,0,0,0,CT,54
6151,Bottom Mid exposed to Top Mid,jks,0,1,-1,27,100,-73,T,54
6152,Apps Hallway,jks,0,0,0,0,0,0,CT,54
6153,Apps Hallway,jks,0,0,0,0,52,-52,T,54
6154,CT Boost,jks,1,0,1,100,69,31,CT,54
6155,CT Boost,jks,0,0,0,0,0,0,T,54
6156,Dark,jks,0,0,0,0,0,0,CT,54
6157,Dark,jks,1,1,0,126,40,86,T,54
6158,Top Coffins,jks,0,0,0,0,0,0,CT,54
6159,Top Coffins,jks,0,0,0,0,0,0,T,54
6160,Lane Side,k0nfig,0,0,0,124,0,124,CT,54
6161,Lane Side,k0nfig,1,3,-2,137,342,-205,T,54
6162,Banana,k0nfig,0,0,0,0,0,0,CT,54
6163,Banana,k0nfig,0,2,-2,38,72,-34,T,54
6164,Pit,k0nfig,0,2,-2,115,200,-85,CT,54
6165,Pit,k0nfig,0,1,-1,0,9,-9,T,54
6166,Pit Peek Towards Lane,k0nfig,2,2,0,148,197,-49,CT,54
6167,Pit Peek Towards Lane,k0nfig,1,0,1,100,91,9,T,54
6168,Lane Patio,k0nfig,0,2,-2,44,200,-156,CT,54
6169,Lane Patio,k0nfig,0,0,0,17,0,17,T,54
6170,A Site,k0nfig,1,1,0,100,15,85,CT,54
6171,A Site,k0nfig,2,2,0,141,186,-45,T,54
6172,Top Balcony ,k0nfig,0,0,0,0,0,0,CT,54
6173,Top Balcony ,k0nfig,0,1,-1,0,14,-14,T,54
6174,Top Mid Lane Side ,k0nfig,0,0,0,0,10,-10,CT,54
6175,Top Mid Lane Side ,k0nfig,0,1,-1,88,100,-12,T,54
6176,Middle,k0nfig,0,1,-1,0,100,-100,CT,54
6177,Middle,k0nfig,0,1,-1,0,169,-169,T,54
6178,B Site,k0nfig,0,1,-1,0,57,-57,CT,54
6179,B Site,k0nfig,0,2,-2,0,145,-145,T,54
6180,Boiler Side Stairs,k0nfig,3,1,2,204,134,70,CT,54
6181,Boiler Side Stairs,k0nfig,0,1,-1,0,100,-100,T,54
6182,Behind Coffins Playing the B Site Cross,k0nfig,1,0,1,100,0,100,CT,54
6183,Behind Coffins Playing the B Site Cross,k0nfig,0,0,0,0,0,0,T,54
6184,CT Banana Half Wall Side,k0nfig,1,1,0,203,100,103,CT,54
6185,CT Banana Half Wall Side,k0nfig,0,1,-1,0,100,-100,T,54
6186,A Site Behind Middle Boxes/Pillar hidden from Lane,k0nfig,0,1,-1,44,75,-31,CT,54
6187,A Site Behind Middle Boxes/Pillar hidden from Lane,k0nfig,0,0,0,0,0,0,T,54
6188,CT Boost,k0nfig,0,0,0,0,0,0,CT,54
6189,CT Boost,k0nfig,0,0,0,0,0,0,T,54
6190,Outside Library,k0nfig,0,0,0,0,0,0,CT,54
6191,Outside Library,k0nfig,1,0,1,100,0,100,T,54
6192,Apartments Cubby,k0nfig,0,1,-1,0,100,-100,CT,54
6193,Apartments Cubby,k0nfig,0,0,0,0,0,0,T,54
6194,CT Outside Construction,k0nfig,0,0,0,0,0,0,CT,54
6195,CT Outside Construction,k0nfig,0,0,0,0,0,0,T,54
6196,B Site Cross for T's Exposed to CT and Quad,k0nfig,0,0,0,0,0,0,CT,54
6197,B Site Cross for T's Exposed to CT and Quad,k0nfig,1,0,1,91,0,91,T,54
6198,A Site Left Side Middle Boxes,k0nfig,0,0,0,0,0,0,CT,54
6199,A Site Left Side Middle Boxes,k0nfig,0,0,0,0,0,0,T,54
6200,A Site Right Side Middle Pillar,k0nfig,0,0,0,0,0,0,CT,54
6201,A Site Right Side Middle Pillar,k0nfig,0,0,0,0,0,0,T,54
6202,Chokepoint Entering B,k0nfig,0,0,0,0,0,0,CT,54
6203,Chokepoint Entering B,k0nfig,0,0,0,0,0,0,T,54
6204,Lane Behind Pillar,k0nfig,0,1,-1,88,100,-12,CT,54
6205,Lane Behind Pillar,k0nfig,0,0,0,0,0,0,T,54
6206,Quad Box,k0nfig,0,0,0,0,6,-6,CT,54
6207,Quad Box,k0nfig,0,0,0,0,0,0,T,54
6208,Back Alley,k0nfig,1,0,1,68,35,33,CT,54
6209,Back Alley,k0nfig,0,0,0,0,0,0,T,54
6210,BackRoad,k0nfig,0,1,-1,0,100,-100,CT,54
6211,BackRoad,k0nfig,0,0,0,0,0,0,T,54
6212,Behind B Site Back Pillar,k0nfig,0,1,-1,0,1,-1,CT,54
6213,Behind B Site Back Pillar,k0nfig,0,0,0,0,0,0,T,54
6214,A Site Behind Default Boxes,k0nfig,0,0,0,0,0,0,CT,54
6215,A Site Behind Default Boxes,k0nfig,0,0,0,0,0,0,T,54
6216,Apartments,k0nfig,0,1,-1,44,100,-56,CT,54
6217,Apartments,k0nfig,0,0,0,0,0,0,T,54
6218,Deep CT Peeking Towards B Site,k0nfig,0,1,-1,0,100,-100,CT,54
6219,Deep CT Peeking Towards B Site,k0nfig,0,0,0,0,0,0,T,54
6220,Top Mid Chokepoint,k0nfig,0,0,0,0,0,0,CT,54
6221,Top Mid Chokepoint,k0nfig,0,1,-1,27,100,-73,T,54
6222,Bottom Mid Banana,k0nfig,0,0,0,0,0,0,CT,54
6223,Bottom Mid Banana,k0nfig,0,0,0,0,84,-84,T,54
6224,CT Banana Sandbags Right Corner,k0nfig,0,0,0,0,29,-29,CT,54
6225,CT Banana Sandbags Right Corner,k0nfig,0,1,-1,52,100,-48,T,54
6226,Pit Below Balcony,k0nfig,1,1,0,148,100,48,CT,54
6227,Pit Below Balcony,k0nfig,0,0,0,0,0,0,T,54
6228,CT Peek Towards B Choke,k0nfig,0,0,0,0,0,0,CT,54
6229,CT Peek Towards B Choke,k0nfig,0,1,-1,0,100,-100,T,54
6230,2nd Oranges,k0nfig,0,0,0,0,0,0,CT,54
6231,2nd Oranges,k0nfig,3,0,3,121,0,121,T,54
6232,T Apps,k0nfig,0,1,-1,0,61,-61,CT,54
6233,T Apps,k0nfig,0,0,0,0,0,0,T,54
6234,Arch Side,k0nfig,0,0,0,3,0,3,CT,54
6235,Arch Side,k0nfig,1,0,1,100,18,82,T,54
6236,CT Banana Sandbangs,k0nfig,1,0,1,239,14,225,CT,54
6237,CT Banana Sandbangs,k0nfig,0,1,-1,0,17,-17,T,54
6238,Banana,chelo,0,0,0,16,20,-4,CT,49
6239,Banana,chelo,0,4,-4,0,494,-494,T,49
6240,CT Banana Half Wall Side,chelo,4,1,3,506,226,280,CT,49
6241,CT Banana Half Wall Side,chelo,0,1,-1,47,134,-87,T,49
6242,Chokepoint Entering B,chelo,1,0,1,213,48,165,CT,49
6243,Chokepoint Entering B,chelo,0,2,-2,12,200,-188,T,49
6244,CT Banana Barrels,chelo,3,4,-1,545,404,141,CT,49
6245,CT Banana Barrels,chelo,0,0,0,0,0,0,T,49
6246,Top Mid Arch Side,chelo,0,1,-1,72,100,-28,CT,49
6247,Top Mid Arch Side,chelo,1,2,-1,100,171,-71,T,49
6248,CT Banana Sandbags Right Corner,chelo,1,1,0,100,100,0,CT,49
6249,CT Banana Sandbags Right Corner,chelo,0,0,0,0,0,0,T,49
6250,CT Banana Sandbangs,chelo,5,1,4,590,206,384,CT,49
6251,CT Banana Sandbangs,chelo,0,1,-1,19,21,-2,T,49
6252,A Bombsite Close Left,chelo,1,0,1,6,0,6,CT,49
6253,A Bombsite Close Left,chelo,0,1,-1,0,97,-97,T,49
6254,Logs,chelo,0,0,0,0,6,-6,CT,49
6255,Logs,chelo,1,1,0,117,105,12,T,49
6256,2nd Oranges,chelo,2,2,0,171,178,-7,CT,49
6257,2nd Oranges,chelo,0,0,0,0,0,0,T,49
6258,Lane Side,chelo,1,0,1,60,28,32,CT,49
6259,Lane Side,chelo,1,2,-1,124,226,-102,T,49
6260,CT Peek Towards B Choke,chelo,0,1,-1,63,100,-37,CT,49
6261,CT Peek Towards B Choke,chelo,0,1,-1,0,56,-56,T,49
6262,CT Boost,chelo,0,0,0,0,0,0,CT,49
6263,CT Boost,chelo,0,0,0,0,0,0,T,49
6264,Dark,chelo,1,2,-1,54,115,-61,CT,49
6265,Dark,chelo,1,0,1,100,0,100,T,49
6266,Top Mid Lane Side ,chelo,0,0,0,0,0,0,CT,49
6267,Top Mid Lane Side ,chelo,0,1,-1,0,26,-26,T,49
6268,Balcony,chelo,0,0,0,0,0,0,CT,49
6269,Balcony,chelo,0,0,0,0,0,0,T,49
6270,A Bombsite Back Site,chelo,0,0,0,0,0,0,CT,49
6271,A Bombsite Back Site,chelo,0,0,0,0,0,0,T,49
6272,B Site Cross for T's Exposed to CT and Quad,chelo,0,0,0,40,0,40,CT,49
6273,B Site Cross for T's Exposed to CT and Quad,chelo,0,0,0,26,0,26,T,49
6274,Outside Library,chelo,0,1,-1,22,100,-78,CT,49
6275,Outside Library,chelo,0,0,0,0,0,0,T,49
6276,Default Plant A Site,chelo,0,0,0,0,0,0,CT,49
6277,Default Plant A Site,chelo,0,1,-1,0,74,-74,T,49
6278,Grill,chelo,0,0,0,0,0,0,CT,49
6279,Grill,chelo,1,0,1,74,21,53,T,49
6280,Pit Peek Towards Lane,chelo,0,0,0,0,0,0,CT,49
6281,Pit Peek Towards Lane,chelo,0,0,0,0,0,0,T,49
6282,B Site,chelo,0,1,-1,21,100,-79,CT,49
6283,B Site,chelo,0,0,0,0,0,0,T,49
6284,A Site,chelo,0,1,-1,0,34,-34,CT,49
6285,A Site,chelo,0,0,0,0,0,0,T,49
6286,Apartments,chelo,0,1,-1,0,1,-1,CT,49
6287,Apartments,chelo,0,0,0,0,0,0,T,49
6288,Behind Coffins Playing the B Site Cross,chelo,1,1,0,127,100,27,CT,49
6289,Behind Coffins Playing the B Site Cross,chelo,0,0,0,0,0,0,T,49
6290,Arch Side,chelo,0,0,0,0,0,0,CT,49
6291,Arch Side,chelo,0,0,0,0,0,0,T,49
6292,Pit,chelo,0,0,0,0,0,0,CT,49
6293,Pit,chelo,1,0,1,75,0,75,T,49
6294,Top Graveyard,chelo,0,0,0,0,0,0,CT,49
6295,Top Graveyard,chelo,0,1,-1,0,10,-10,T,49
6296,Top Mid Chokepoint,chelo,0,0,0,0,0,0,CT,49
6297,Top Mid Chokepoint,chelo,0,1,-1,0,122,-122,T,49
6298,Bottom Mid Banana,chelo,0,0,0,0,0,0,CT,49
6299,Bottom Mid Banana,chelo,0,0,0,0,0,0,T,49
6300,T Ramp Peeking Towards Mid,chelo,0,0,0,0,0,0,CT,49
6301,T Ramp Peeking Towards Mid,chelo,0,1,-1,34,175,-141,T,49
6302,Banana,allu,0,0,0,0,0,0,CT,64
6303,Banana,allu,3,6,-3,211,664,-453,T,64
6304,Top Mid Lane Side ,allu,0,2,-2,7,157,-150,CT,64
6305,Top Mid Lane Side ,allu,0,0,0,0,0,0,T,64
6306,Lane Side,allu,0,2,-2,0,279,-279,CT,64
6307,Lane Side,allu,1,2,-1,241,184,57,T,64
6308,Top Mid Arch Side,allu,0,1,-1,102,190,-88,CT,64
6309,Top Mid Arch Side,allu,0,2,-2,11,200,-189,T,64
6310,CT Banana Sandbangs,allu,0,2,-2,97,200,-103,CT,64
6311,CT Banana Sandbangs,allu,1,0,1,100,22,78,T,64
6312,CT Banana Half Wall Side,allu,0,2,-2,52,153,-101,CT,64
6313,CT Banana Half Wall Side,allu,1,1,0,150,48,102,T,64
6314,A Site,allu,3,1,2,202,242,-40,CT,64
6315,A Site,allu,0,1,-1,0,100,-100,T,64
6316,Top Balcony ,allu,1,2,-1,100,176,-76,CT,64
6317,Top Balcony ,allu,1,1,0,100,100,0,T,64
6318,Arch Side,allu,4,3,1,484,372,112,CT,64
6319,Arch Side,allu,0,0,0,34,68,-34,T,64
6320,A Bombsite Back Site,allu,0,2,-2,115,200,-85,CT,64
6321,A Bombsite Back Site,allu,0,0,0,0,0,0,T,64
6322,Chokepoint Entering B,allu,1,1,0,202,147,55,CT,64
6323,Chokepoint Entering B,allu,0,0,0,61,0,61,T,64
6324,A Bombsite Close Left,allu,0,1,-1,96,74,22,CT,64
6325,A Bombsite Close Left,allu,0,0,0,0,0,0,T,64
6326,B Site Cross for T's Exposed to CT and Quad,allu,1,1,0,187,27,160,CT,64
6327,B Site Cross for T's Exposed to CT and Quad,allu,0,1,-1,57,100,-43,T,64
6328,A Site Behind Default Boxes,allu,0,2,-2,78,223,-145,CT,64
6329,A Site Behind Default Boxes,allu,0,0,0,0,0,0,T,64
6330,Middle,allu,0,0,0,0,0,0,CT,64
6331,Middle,allu,0,2,-2,80,136,-56,T,64
6332,Pit Peek Towards Lane,allu,0,0,0,0,0,0,CT,64
6333,Pit Peek Towards Lane,allu,0,0,0,0,0,0,T,64
6334,Boiler Side Stairs,allu,0,1,-1,10,6,4,CT,64
6335,Boiler Side Stairs,allu,0,0,0,0,0,0,T,64
6336,CT Outside Kitchen,allu,0,0,0,0,0,0,CT,64
6337,CT Outside Kitchen,allu,0,0,0,0,0,0,T,64
6338,Chokepoint Entrance onto A site from Library Side,allu,0,0,0,0,0,0,CT,64
6339,Chokepoint Entrance onto A site from Library Side,allu,0,0,0,0,0,0,T,64
6340,CT Outside Construction,allu,0,1,-1,157,100,57,CT,64
6341,CT Outside Construction,allu,0,0,0,0,0,0,T,64
6342,CT Banana Barrels,allu,0,1,-1,0,100,-100,CT,64
6343,CT Banana Barrels,allu,0,0,0,0,0,0,T,64
6344,B Site,allu,0,1,-1,0,74,-74,CT,64
6345,B Site,allu,0,0,0,0,0,0,T,64
6346,Logs,allu,0,0,0,0,0,0,CT,64
6347,Logs,allu,0,0,0,0,0,0,T,64
6348,Apps Hallway,allu,0,0,0,0,0,0,CT,64
6349,Apps Hallway,allu,1,1,0,91,100,-9,T,64
6350,Deep Apps Past Hallway,allu,0,0,0,0,0,0,CT,64
6351,Deep Apps Past Hallway,allu,2,0,2,200,0,200,T,64
6352,Lane Patio,allu,0,1,-1,44,104,-60,CT,64
6353,Lane Patio,allu,0,0,0,0,0,0,T,64
6354,Right Side Quadbox Peek for a CT,allu,0,0,0,0,0,0,CT,64
6355,Right Side Quadbox Peek for a CT,allu,0,1,-1,65,100,-35,T,64
6356,Behind Coffins Playing the B Site Cross,allu,0,1,-1,0,100,-100,CT,64
6357,Behind Coffins Playing the B Site Cross,allu,0,0,0,0,0,0,T,64
6358,T Apps Bridge ,allu,0,1,-1,0,100,-100,CT,64
6359,T Apps Bridge ,allu,0,0,0,0,0,0,T,64
6360,Library,allu,3,1,2,200,104,96,CT,64
6361,Library,allu,0,0,0,0,0,0,T,64
6362,CT Tree,allu,0,1,-1,0,100,-100,CT,64
6363,CT Tree,allu,0,0,0,0,0,0,T,64
6364,CT Spawn ,allu,1,1,0,174,100,74,CT,64
6365,CT Spawn ,allu,0,0,0,0,0,0,T,64
6366,A Site Left Side Middle Boxes,allu,0,0,0,0,0,0,CT,64
6367,A Site Left Side Middle Boxes,allu,0,0,0,0,0,0,T,64
6368,CT Arch,allu,0,0,0,0,0,0,CT,64
6369,CT Arch,allu,0,1,-1,0,32,-32,T,64
6370,CT Banana Sandbags Right Corner,allu,0,0,0,0,0,0,CT,64
6371,CT Banana Sandbags Right Corner,allu,0,0,0,0,0,0,T,64
6372,T Ramp Ledge,allu,0,0,0,0,0,0,CT,64
6373,T Ramp Ledge,allu,0,0,0,0,0,0,T,64
6374,Arch Side Cubby,allu,0,1,-1,59,50,9,CT,64
6375,Arch Side Cubby,allu,0,0,0,0,0,0,T,64
6376,SecondMid,allu,0,0,0,0,0,0,CT,64
6377,SecondMid,allu,1,0,1,100,22,78,T,64
6378,Deep CT Peeking Towards B Site,allu,0,1,-1,0,100,-100,CT,64
6379,Deep CT Peeking Towards B Site,allu,0,0,0,0,0,0,T,64
6380,CT Peek Towards B Choke,allu,1,1,0,123,126,-3,CT,64
6381,CT Peek Towards B Choke,allu,0,0,0,0,0,0,T,64
6382,Pit,allu,0,0,0,0,0,0,CT,64
6383,Pit,allu,0,0,0,0,0,0,T,64
6384,Lane Side,Brollan,2,3,-1,193,284,-91,CT,48
6385,Lane Side,Brollan,0,0,0,0,0,0,T,48
6386,B Site Cross for T's Exposed to CT and Quad,Brollan,0,2,-2,49,39,10,CT,48
6387,B Site Cross for T's Exposed to CT and Quad,Brollan,0,0,0,0,0,0,T,48
6388,Arch Side,Brollan,0,1,-1,0,40,-40,CT,48
6389,Arch Side,Brollan,1,1,0,99,119,-20,T,48
6390,Chokepoint Entering B,Brollan,1,0,1,136,35,101,CT,48
6391,Chokepoint Entering B,Brollan,1,0,1,124,15,109,T,48
6392,Top Mid Lane Side ,Brollan,0,0,0,0,0,0,CT,48
6393,Top Mid Lane Side ,Brollan,1,1,0,135,142,-7,T,48
6394,SecondMid,Brollan,0,0,0,0,0,0,CT,48
6395,SecondMid,Brollan,0,2,-2,27,126,-99,T,48
6396,CT Banana Half Wall Side,Brollan,0,0,0,22,0,22,CT,48
6397,CT Banana Half Wall Side,Brollan,3,2,1,367,218,149,T,48
6398,Behind Coffins Playing the B Site Cross,Brollan,2,1,1,34,128,-94,CT,48
6399,Behind Coffins Playing the B Site Cross,Brollan,0,0,0,0,0,0,T,48
6400,Pit Peek Towards Lane,Brollan,1,2,-1,231,220,11,CT,48
6401,Pit Peek Towards Lane,Brollan,0,0,0,0,0,0,T,48
6402,Apartments,Brollan,0,2,-2,37,199,-162,CT,48
6403,Apartments,Brollan,0,0,0,0,0,0,T,48
6404,Grill,Brollan,0,1,-1,0,100,-100,CT,48
6405,Grill,Brollan,0,1,-1,23,87,-64,T,48
6406,Middle,Brollan,1,1,0,27,100,-73,CT,48
6407,Middle,Brollan,0,0,0,0,0,0,T,48
6408,Front Coffins,Brollan,0,1,-1,0,100,-100,CT,48
6409,Front Coffins,Brollan,0,0,0,0,0,0,T,48
6410,Deep Apps Past Hallway,Brollan,0,1,-1,0,139,-139,CT,48
6411,Deep Apps Past Hallway,Brollan,0,0,0,0,6,-6,T,48
6412,Top Mid Arch Side,Brollan,0,0,0,0,0,0,CT,48
6413,Top Mid Arch Side,Brollan,0,1,-1,122,62,60,T,48
6414,Outside Library,Brollan,0,0,0,0,0,0,CT,48
6415,Outside Library,Brollan,0,0,0,0,0,0,T,48
6416,Pit,Brollan,0,0,0,0,0,0,CT,48
6417,Pit,Brollan,0,0,0,0,0,0,T,48
6418,Underpass,Brollan,0,0,0,0,0,0,CT,48
6419,Underpass,Brollan,0,1,-1,0,100,-100,T,48
6420,Lane Peek Towards Top Mid,Brollan,0,0,0,0,0,0,CT,48
6421,Lane Peek Towards Top Mid,Brollan,0,0,0,0,0,0,T,48
6422,Boiler Peek to Mid,Brollan,0,0,0,2,0,2,CT,48
6423,Boiler Peek to Mid,Brollan,0,1,-1,12,100,-88,T,48
6424,Fountain,Brollan,0,0,0,0,0,0,CT,48
6425,Fountain,Brollan,0,0,0,0,0,0,T,48
6426,A Site,Brollan,0,0,0,97,20,77,CT,48
6427,A Site,Brollan,1,1,0,112,100,12,T,48
6428,Banana,Brollan,0,0,0,0,0,0,CT,48
6429,Banana,Brollan,0,0,0,0,2,-2,T,48
6430,B Site,Brollan,1,0,1,22,1,21,CT,48
6431,B Site,Brollan,0,0,0,0,0,0,T,48
6432,Bottom Mid Banana,Brollan,0,1,-1,0,88,-88,CT,48
6433,Bottom Mid Banana,Brollan,0,0,0,0,0,0,T,48
6434,Library,Brollan,0,0,0,0,0,0,CT,48
6435,Library,Brollan,0,0,0,0,0,0,T,48
6436,CT Peek Towards B Choke,Brollan,4,0,4,268,106,162,CT,48
6437,CT Peek Towards B Choke,Brollan,0,0,0,0,0,0,T,48
6438,A Bombsite Close Left,Brollan,0,1,-1,30,100,-70,CT,48
6439,A Bombsite Close Left,Brollan,0,0,0,0,0,0,T,48
6440,CT Outside Arch,Brollan,0,0,0,0,0,0,CT,48
6441,CT Outside Arch,Brollan,0,0,0,0,0,0,T,48
6442,Top Coffins,Brollan,0,1,-1,35,72,-37,CT,48
6443,Top Coffins,Brollan,0,0,0,0,0,0,T,48
6444,Top Balcony ,Brollan,0,0,0,0,0,0,CT,48
6445,Top Balcony ,Brollan,0,1,-1,61,94,-33,T,48
6446,CT Boost,Brollan,1,0,1,79,0,79,CT,48
6447,CT Boost,Brollan,0,0,0,0,0,0,T,48
6448,2nd Oranges,Brollan,0,0,0,0,0,0,CT,48
6449,2nd Oranges,Brollan,0,0,0,0,0,0,T,48
6450,Left Side Quadbox Peek for a CT,Brollan,0,0,0,0,0,0,CT,48
6451,Left Side Quadbox Peek for a CT,Brollan,0,0,0,0,0,0,T,48
6452,A Bombsite Back Site,Brollan,0,0,0,0,0,0,CT,48
6453,A Bombsite Back Site,Brollan,0,1,-1,54,100,-46,T,48
6454,T Ramp Peeking Towards Mid,Brollan,0,0,0,0,0,0,CT,48
6455,T Ramp Peeking Towards Mid,Brollan,0,1,-1,0,113,-113,T,48
6456,Chokepoint Entering B,Snappi,0,4,-4,258,438,-180,CT,64
6457,Chokepoint Entering B,Snappi,1,1,0,65,122,-57,T,64
6458,CT Banana Half Wall Side,Snappi,0,4,-4,274,413,-139,CT,64
6459,CT Banana Half Wall Side,Snappi,1,0,1,12,27,-15,T,64
6460,CT Banana Sandbangs,Snappi,1,4,-3,327,336,-9,CT,64
6461,CT Banana Sandbangs,Snappi,0,0,0,14,0,14,T,64
6462,B Site,Snappi,3,2,1,238,212,26,CT,64
6463,B Site,Snappi,0,0,0,0,0,0,T,64
6464,Behind Coffins Playing the B Site Cross,Snappi,1,3,-2,115,244,-129,CT,64
6465,Behind Coffins Playing the B Site Cross,Snappi,0,0,0,0,0,0,T,64
6466,Banana,Snappi,2,0,2,200,80,120,CT,64
6467,Banana,Snappi,0,3,-3,111,306,-195,T,64
6468,Top Mid Lane Side ,Snappi,0,0,0,14,0,14,CT,64
6469,Top Mid Lane Side ,Snappi,1,1,0,89,144,-55,T,64
6470,CT Near Well,Snappi,0,0,0,0,0,0,CT,64
6471,CT Near Well,Snappi,0,2,-2,22,200,-178,T,64
6472,1st Oranges,Snappi,0,0,0,0,0,0,CT,64
6473,1st Oranges,Snappi,0,0,0,0,0,0,T,64
6474,A Bombsite Close Left,Snappi,0,0,0,0,0,0,CT,64
6475,A Bombsite Close Left,Snappi,0,2,-2,0,148,-148,T,64
6476,Grill,Snappi,0,0,0,59,0,59,CT,64
6477,Grill,Snappi,2,0,2,121,59,62,T,64
6478,Top Mid Arch Side,Snappi,1,1,0,166,127,39,CT,64
6479,Top Mid Arch Side,Snappi,0,1,-1,88,100,-12,T,64
6480,B Site Cross for T's Exposed to CT and Quad,Snappi,0,0,0,0,0,0,CT,64
6481,B Site Cross for T's Exposed to CT and Quad,Snappi,0,0,0,0,0,0,T,64
6482,Top Coffins,Snappi,0,2,-2,104,306,-202,CT,64
6483,Top Coffins,Snappi,0,0,0,0,0,0,T,64
6484,T Ramp Peeking Towards Mid,Snappi,0,0,0,0,0,0,CT,64
6485,T Ramp Peeking Towards Mid,Snappi,0,1,-1,34,150,-116,T,64
6486,Outside Library,Snappi,0,2,-2,0,200,-200,CT,64
6487,Outside Library,Snappi,0,0,0,0,0,0,T,64
6488,CT Outside Construction,Snappi,0,1,-1,91,100,-9,CT,64
6489,CT Outside Construction,Snappi,0,0,0,0,0,0,T,64
6490,Middle,Snappi,0,0,0,0,0,0,CT,64
6491,Middle,Snappi,0,1,-1,2,100,-98,T,64
6492,Lane Peek Towards Top Mid,Snappi,0,1,-1,0,100,-100,CT,64
6493,Lane Peek Towards Top Mid,Snappi,0,0,0,0,0,0,T,64
6494,Top Mid Chokepoint,Snappi,0,1,-1,0,100,-100,CT,64
6495,Top Mid Chokepoint,Snappi,0,0,0,0,0,0,T,64
6496,Left Side Quadbox Peek for a CT,Snappi,0,0,0,0,0,0,CT,64
6497,Left Side Quadbox Peek for a CT,Snappi,0,0,0,0,0,0,T,64
6498,CT Banana Barrels,Snappi,0,1,-1,0,152,-152,CT,64
6499,CT Banana Barrels,Snappi,0,0,0,0,0,0,T,64
6500,Dark,Snappi,0,0,0,0,0,0,CT,64
6501,Dark,Snappi,0,1,-1,18,69,-51,T,64
6502,Top Hay Bales,Snappi,0,0,0,0,0,0,CT,64
6503,Top Hay Bales,Snappi,0,0,0,0,0,0,T,64
6504,Chokepoint Entrance onto A site from Library Side,Snappi,0,0,0,0,0,0,CT,64
6505,Chokepoint Entrance onto A site from Library Side,Snappi,0,0,0,0,0,0,T,64
6506,2nd Oranges,Snappi,1,0,1,100,0,100,CT,64
6507,2nd Oranges,Snappi,0,0,0,0,0,0,T,64
6508,CT Banana Sandbags Right Corner,Snappi,2,0,2,120,0,120,CT,64
6509,CT Banana Sandbags Right Corner,Snappi,0,1,-1,0,50,-50,T,64
6510,Bottom Mid Banana,Snappi,0,0,0,0,0,0,CT,64
6511,Bottom Mid Banana,Snappi,0,0,0,0,0,0,T,64
6512,Logs,Snappi,0,0,0,0,0,0,CT,64
6513,Logs,Snappi,0,1,-1,0,100,-100,T,64
6514,Apartments,Snappi,0,1,-1,0,100,-100,CT,64
6515,Apartments,Snappi,0,0,0,0,0,0,T,64
6516,Lane Side,Snappi,0,0,0,0,0,0,CT,64
6517,Lane Side,Snappi,0,1,-1,60,89,-29,T,64
6518,Boiler Room,Snappi,0,0,0,0,0,0,CT,64
6519,Boiler Room,Snappi,0,1,-1,0,3,-3,T,64
6520,Arch Side CT Corner Peeking Towards Top Mid,Snappi,0,0,0,0,0,0,CT,64
6521,Arch Side CT Corner Peeking Towards Top Mid,Snappi,0,1,-1,40,100,-60,T,64
6522,CT Tree,Snappi,0,1,-1,24,100,-76,CT,64
6523,CT Tree,Snappi,0,0,0,0,0,0,T,64
6524,CT Spawn ,Snappi,0,1,-1,22,100,-78,CT,64
6525,CT Spawn ,Snappi,0,0,0,0,0,0,T,64
6526,Right Side Quadbox Peek for a CT,Snappi,0,1,-1,0,97,-97,CT,64
6527,Right Side Quadbox Peek for a CT,Snappi,0,0,0,0,0,0,T,64
6528,Top Balcony ,Snappi,0,1,-1,0,100,-100,CT,64
6529,Top Balcony ,Snappi,1,0,1,73,0,73,T,64
6530,Arch Side Cubby,Snappi,0,0,0,0,0,0,CT,64
6531,Arch Side Cubby,Snappi,0,0,0,0,0,0,T,64
6532,LowerMid,Snappi,0,0,0,0,0,0,CT,64
6533,LowerMid,Snappi,0,0,0,0,0,0,T,64
6534,Lane Side,shz,0,0,0,0,14,-14,CT,49
6535,Lane Side,shz,0,3,-3,92,191,-99,T,49
6536,Top Mid Lane Side ,shz,1,4,-3,23,356,-333,CT,49
6537,Top Mid Lane Side ,shz,0,0,0,0,0,0,T,49
6538,Top Balcony ,shz,0,1,-1,0,81,-81,CT,49
6539,Top Balcony ,shz,1,1,0,182,100,82,T,49
6540,Banana,shz,0,0,0,0,0,0,CT,49
6541,Banana,shz,0,3,-3,88,300,-212,T,49
6542,Behind Coffins Playing the B Site Cross,shz,1,1,0,93,100,-7,CT,49
6543,Behind Coffins Playing the B Site Cross,shz,0,0,0,0,0,0,T,49
6544,Top Mid Arch Side,shz,0,0,0,0,0,0,CT,49
6545,Top Mid Arch Side,shz,1,1,0,96,113,-17,T,49
6546,Lane Behind Pillar,shz,0,0,0,0,0,0,CT,49
6547,Lane Behind Pillar,shz,0,0,0,0,0,0,T,49
6548,Pit,shz,0,1,-1,22,60,-38,CT,49
6549,Pit,shz,0,0,0,0,0,0,T,49
6550,Underpass,shz,0,0,0,0,0,0,CT,49
6551,Underpass,shz,0,1,-1,74,100,-26,T,49
6552,CT Banana Sandbangs,shz,0,0,0,0,0,0,CT,49
6553,CT Banana Sandbangs,shz,0,1,-1,38,18,20,T,49
6554,CT Spawn ,shz,1,0,1,46,0,46,CT,49
6555,CT Spawn ,shz,0,0,0,0,0,0,T,49
6556,Apartments,shz,0,0,0,0,0,0,CT,49
6557,Apartments,shz,0,0,0,0,35,-35,T,49
6558,A Site,shz,2,0,2,218,0,218,CT,49
6559,A Site,shz,0,0,0,0,0,0,T,49
6560,B Site,shz,0,0,0,0,0,0,CT,49
6561,B Site,shz,0,1,-1,0,100,-100,T,49
6562,Top Mid Chokepoint,shz,0,0,0,0,0,0,CT,49
6563,Top Mid Chokepoint,shz,0,1,-1,0,100,-100,T,49
6564,Grill,shz,0,0,0,0,0,0,CT,49
6565,Grill,shz,0,0,0,0,0,0,T,49
6566,Top Hay Bales,shz,0,1,-1,0,30,-30,CT,49
6567,Top Hay Bales,shz,0,0,0,0,0,0,T,49
6568,Boiler Peek to Mid,shz,0,0,0,0,0,0,CT,49
6569,Boiler Peek to Mid,shz,1,1,0,100,100,0,T,49
6570,A Site Behind Default Boxes,shz,0,1,-1,40,100,-60,CT,49
6571,A Site Behind Default Boxes,shz,0,0,0,0,0,0,T,49
6572,Lane Patio,shz,2,1,1,144,178,-34,CT,49
6573,Lane Patio,shz,0,0,0,0,0,0,T,49
6574,Apartments Hallway Peek from T Side,shz,0,0,0,72,27,45,CT,49
6575,Apartments Hallway Peek from T Side,shz,0,1,-1,0,103,-103,T,49
6576,CT Banana Half Wall Side,shz,0,0,0,0,0,0,CT,49
6577,CT Banana Half Wall Side,shz,0,1,-1,68,74,-6,T,49
6578,Deep CT Peeking Towards B Site,shz,1,0,1,10,26,-16,CT,49
6579,Deep CT Peeking Towards B Site,shz,0,0,0,0,0,0,T,49
6580,Bottom Mid Banana,shz,0,0,0,0,0,0,CT,49
6581,Bottom Mid Banana,shz,0,0,0,0,0,0,T,49
6582,TopofMid,shz,0,0,0,0,0,0,CT,49
6583,TopofMid,shz,0,0,0,0,0,0,T,49
6584,SecondMid,shz,0,0,0,0,0,0,CT,49
6585,SecondMid,shz,1,1,0,100,100,0,T,49
6586,Pit Below Balcony,shz,0,1,-1,87,100,-13,CT,49
6587,Pit Below Balcony,shz,0,0,0,0,0,0,T,49
6588,Graveyard Stairs,shz,0,0,0,0,0,0,CT,49
6589,Graveyard Stairs,shz,1,1,0,100,97,3,T,49
6590,Chokepoint Entering B,shz,0,0,0,0,95,-95,CT,49
6591,Chokepoint Entering B,shz,0,1,-1,54,100,-46,T,49
6592,A Bombsite Back Site,shz,0,1,-1,0,1,-1,CT,49
6593,A Bombsite Back Site,shz,0,0,0,0,0,0,T,49
6594,Arch Side,shz,0,0,0,0,0,0,CT,49
6595,Arch Side,shz,0,0,0,0,0,0,T,49
6596,Apps T Side Stairs,shz,0,0,0,0,0,0,CT,49
6597,Apps T Side Stairs,shz,0,1,-1,0,121,-121,T,49
6598,Lane Side,poizon,0,1,-1,14,140,-126,CT,54
6599,Lane Side,poizon,1,2,-1,100,140,-40,T,54
6600,Middle,poizon,0,2,-2,0,200,-200,CT,54
6601,Middle,poizon,0,1,-1,37,59,-22,T,54
6602,Banana,poizon,0,1,-1,0,100,-100,CT,54
6603,Banana,poizon,1,3,-2,406,526,-120,T,54
6604,CT Banana Sandbangs,poizon,0,0,0,0,9,-9,CT,54
6605,CT Banana Sandbangs,poizon,1,2,-1,132,157,-25,T,54
6606,CT Banana Half Wall Side,poizon,0,0,0,0,0,0,CT,54
6607,CT Banana Half Wall Side,poizon,3,2,1,409,217,192,T,54
6608,Logs,poizon,0,0,0,0,0,0,CT,54
6609,Logs,poizon,0,2,-2,0,100,-100,T,54
6610,A Bombsite Close Left,poizon,0,1,-1,0,58,-58,CT,54
6611,A Bombsite Close Left,poizon,0,1,-1,0,82,-82,T,54
6612,Grill,poizon,0,0,0,0,0,0,CT,54
6613,Grill,poizon,0,1,-1,0,52,-52,T,54
6614,Lane Behind Pillar,poizon,0,2,-2,87,100,-13,CT,54
6615,Lane Behind Pillar,poizon,0,0,0,0,0,0,T,54
6616,Chokepoint Entrance onto A site from Library Side,poizon,0,2,-2,52,112,-60,CT,54
6617,Chokepoint Entrance onto A site from Library Side,poizon,1,0,1,100,56,44,T,54
6618,Top Mid Arch Side,poizon,1,1,0,100,100,0,CT,54
6619,Top Mid Arch Side,poizon,0,0,0,0,0,0,T,54
6620,B Site Cross for T's Exposed to CT and Quad,poizon,0,0,0,0,0,0,CT,54
6621,B Site Cross for T's Exposed to CT and Quad,poizon,0,1,-1,0,74,-74,T,54
6622,A Site,poizon,2,1,1,284,100,184,CT,54
6623,A Site,poizon,2,0,2,146,0,146,T,54
6624,Apartments,poizon,1,1,0,100,100,0,CT,54
6625,Apartments,poizon,0,0,0,0,0,0,T,54
6626,CT Peek Towards B Choke,poizon,1,0,1,147,0,147,CT,54
6627,CT Peek Towards B Choke,poizon,0,0,0,0,28,-28,T,54
6628,Library,poizon,1,1,0,78,100,-22,CT,54
6629,Library,poizon,1,0,1,100,0,100,T,54
6630,CT Outside Construction,poizon,0,0,0,0,0,0,CT,54
6631,CT Outside Construction,poizon,0,1,-1,0,60,-60,T,54
6632,CT Banana Sandbags Right Corner,poizon,0,0,0,0,0,0,CT,54
6633,CT Banana Sandbags Right Corner,poizon,0,2,-2,0,110,-110,T,54
6634,Top Balcony ,poizon,0,0,0,23,0,23,CT,54
6635,Top Balcony ,poizon,0,1,-1,0,38,-38,T,54
6636,Chokepoint Entering B,poizon,0,0,0,63,79,-16,CT,54
6637,Chokepoint Entering B,poizon,1,0,1,124,50,74,T,54
6638,Pit,poizon,0,0,0,0,0,0,CT,54
6639,Pit,poizon,0,0,0,0,0,0,T,54
6640,CT Banana Barrels,poizon,0,1,-1,0,100,-100,CT,54
6641,CT Banana Barrels,poizon,1,0,1,12,51,-39,T,54
6642,Arch Side,poizon,1,1,0,144,100,44,CT,54
6643,Arch Side,poizon,0,0,0,2,0,2,T,54
6644,Boiler Peek to Mid,poizon,0,1,-1,23,94,-71,CT,54
6645,Boiler Peek to Mid,poizon,0,0,0,0,0,0,T,54
6646,Deep Apps Past Hallway,poizon,0,1,-1,32,66,-34,CT,54
6647,Deep Apps Past Hallway,poizon,0,0,0,0,0,0,T,54
6648,Left Side Quadbox Peek for a CT,poizon,0,1,-1,0,100,-100,CT,54
6649,Left Side Quadbox Peek for a CT,poizon,0,0,0,0,0,0,T,54
6650,Graveyard Stairs,poizon,0,1,-1,0,100,-100,CT,54
6651,Graveyard Stairs,poizon,0,0,0,0,0,0,T,54
6652,Apps Hallway,poizon,0,0,0,0,100,-100,CT,54
6653,Apps Hallway,poizon,0,0,0,0,0,0,T,54
6654,Deep CT Peeking Towards B Site,poizon,0,0,0,0,0,0,CT,54
6655,Deep CT Peeking Towards B Site,poizon,0,0,0,0,0,0,T,54
6656,Quad Box,poizon,0,0,0,0,0,0,CT,54
6657,Quad Box,poizon,0,0,0,73,0,73,T,54
6658,CT Outside Kitchen,poizon,0,0,0,0,0,0,CT,54
6659,CT Outside Kitchen,poizon,0,0,0,0,0,0,T,54
6660,Behind Coffins Playing the B Site Cross,poizon,0,0,0,0,0,0,CT,54
6661,Behind Coffins Playing the B Site Cross,poizon,0,0,0,0,0,0,T,54
6662,CT Banana Close Left Half Wall,poizon,0,0,0,0,0,0,CT,54
6663,CT Banana Close Left Half Wall,poizon,0,1,-1,0,0,0,T,54
6664,T Ramp Peeking Towards Mid,poizon,0,0,0,0,0,0,CT,54
6665,T Ramp Peeking Towards Mid,poizon,0,1,-1,37,226,-189,T,54
6666,A Bombsite Close Left,doto,0,0,0,0,0,0,CT,64
6667,A Bombsite Close Left,doto,0,1,-1,0,100,-100,T,64
6668,Lane Side,doto,0,4,-4,0,400,-400,CT,64
6669,Lane Side,doto,0,1,-1,48,123,-75,T,64
6670,Top Balcony ,doto,4,3,1,214,273,-59,CT,64
6671,Top Balcony ,doto,0,1,-1,0,56,-56,T,64
6672,Arch Side,doto,0,1,-1,16,100,-84,CT,64
6673,Arch Side,doto,0,2,-2,0,177,-177,T,64
6674,Pit,doto,1,3,-2,192,212,-20,CT,64
6675,Pit,doto,0,1,-1,27,84,-57,T,64
6676,SecondMid,doto,0,1,-1,0,100,-100,CT,64
6677,SecondMid,doto,0,2,-2,45,204,-159,T,64
6678,Top Mid Arch Side,doto,0,1,-1,18,135,-117,CT,64
6679,Top Mid Arch Side,doto,0,1,-1,0,100,-100,T,64
6680,B Site,doto,0,2,-2,0,97,-97,CT,64
6681,B Site,doto,0,1,-1,0,100,-100,T,64
6682,A Site Right Side Middle Pillar,doto,3,2,1,233,181,52,CT,64
6683,A Site Right Side Middle Pillar,doto,0,0,0,0,0,0,T,64
6684,Apartments Hallway Peek from T Side,doto,0,0,0,0,0,0,CT,64
6685,Apartments Hallway Peek from T Side,doto,0,1,-1,0,100,-100,T,64
6686,Top Mid Chokepoint,doto,0,1,-1,0,158,-158,CT,64
6687,Top Mid Chokepoint,doto,0,0,0,49,27,22,T,64
6688,Top Mid Lane Side ,doto,1,1,0,46,119,-73,CT,64
6689,Top Mid Lane Side ,doto,0,1,-1,0,100,-100,T,64
6690,A Site Behind Middle Boxes/Pillar hidden from Lane,doto,2,2,0,199,193,6,CT,64
6691,A Site Behind Middle Boxes/Pillar hidden from Lane,doto,0,0,0,0,0,0,T,64
6692,Pit Below Balcony,doto,0,1,-1,54,98,-44,CT,64
6693,Pit Below Balcony,doto,1,1,0,100,91,9,T,64
6694,A Site,doto,0,2,-2,0,165,-165,CT,64
6695,A Site,doto,0,0,0,0,0,0,T,64
6696,2nd Oranges,doto,0,0,0,0,0,0,CT,64
6697,2nd Oranges,doto,0,0,0,0,0,0,T,64
6698,A Bombsite Back Site,doto,0,0,0,1,0,1,CT,64
6699,A Bombsite Back Site,doto,0,1,-1,0,94,-94,T,64
6700,Lane Behind Pillar,doto,0,0,0,0,0,0,CT,64
6701,Lane Behind Pillar,doto,0,1,-1,0,21,-21,T,64
6702,Back Alley,doto,1,0,1,100,27,73,CT,64
6703,Back Alley,doto,0,0,0,0,0,0,T,64
6704,B Site Cross for T's Exposed to CT and Quad,doto,0,0,0,0,0,0,CT,64
6705,B Site Cross for T's Exposed to CT and Quad,doto,0,1,-1,0,87,-87,T,64
6706,Deep CT Peeking Towards B Site,doto,0,1,-1,25,100,-75,CT,64
6707,Deep CT Peeking Towards B Site,doto,0,0,0,0,0,0,T,64
6708,Apps T Side Stairs,doto,0,0,0,0,0,0,CT,64
6709,Apps T Side Stairs,doto,1,1,0,2,100,-98,T,64
6710,Default Plant A Site,doto,0,0,0,0,0,0,CT,64
6711,Default Plant A Site,doto,0,0,0,0,0,0,T,64
6712,Deep Apps Past Hallway,doto,0,1,-1,109,100,9,CT,64
6713,Deep Apps Past Hallway,doto,1,0,1,100,44,56,T,64
6714,Chokepoint Entrance onto A site from Library Side,doto,2,1,1,176,100,76,CT,64
6715,Chokepoint Entrance onto A site from Library Side,doto,0,0,0,0,0,0,T,64
6716,APlatform,doto,0,1,-1,0,100,-100,CT,64
6717,APlatform,doto,0,0,0,0,0,0,T,64
6718,Top Hay Bales,doto,0,0,0,0,0,0,CT,64
6719,Top Hay Bales,doto,0,0,0,0,0,0,T,64
6720,A Site Behind Default Boxes,doto,0,0,0,0,0,0,CT,64
6721,A Site Behind Default Boxes,doto,0,0,0,0,0,0,T,64
6722,Boiler Side Stairs,doto,0,0,0,0,0,0,CT,64
6723,Boiler Side Stairs,doto,0,1,-1,0,185,-185,T,64
6724,Apartments,doto,0,1,-1,0,100,-100,CT,64
6725,Apartments,doto,0,0,0,0,0,0,T,64
6726,Boiler Room,doto,0,0,0,0,0,0,CT,64
6727,Boiler Room,doto,1,0,1,100,0,100,T,64
6728,Pit Peek Towards Lane,doto,2,1,1,220,185,35,CT,64
6729,Pit Peek Towards Lane,doto,0,0,0,0,0,0,T,64
6730,CT Banana Half Wall Side,doto,0,0,0,0,0,0,CT,64
6731,CT Banana Half Wall Side,doto,0,0,0,0,0,0,T,64
6732,Middle,doto,0,1,-1,0,42,-42,CT,64
6733,Middle,doto,0,0,0,0,0,0,T,64
6734,CT Banana Sandbags Right Corner,doto,0,1,-1,0,20,-20,CT,64
6735,CT Banana Sandbags Right Corner,doto,0,0,0,0,0,0,T,64
6736,BackAlley,doto,0,1,-1,0,100,-100,CT,64
6737,BackAlley,doto,0,0,0,0,0,0,T,64
6738,CT Peek Towards B Choke,doto,0,1,-1,0,143,-143,CT,64
6739,CT Peek Towards B Choke,doto,0,0,0,0,0,0,T,64
6740,Chokepoint Entering B,doto,0,1,-1,29,136,-107,CT,64
6741,Chokepoint Entering B,doto,0,0,0,0,13,-13,T,64
6742,T Ramp Peeking Towards Mid,doto,0,0,0,0,0,0,CT,64
6743,T Ramp Peeking Towards Mid,doto,0,1,-1,36,73,-37,T,64
6744,Banana,boltz,0,1,-1,51,100,-49,CT,49
6745,Banana,boltz,2,4,-2,250,404,-154,T,49
6746,Chokepoint Entering B,boltz,3,2,1,229,239,-10,CT,49
6747,Chokepoint Entering B,boltz,1,2,-1,40,238,-198,T,49
6748,CT Banana Half Wall Side,boltz,2,1,1,262,157,105,CT,49
6749,CT Banana Half Wall Side,boltz,1,2,-1,100,148,-48,T,49
6750,CT Banana Sandbangs,boltz,0,2,-2,219,172,47,CT,49
6751,CT Banana Sandbangs,boltz,0,1,-1,44,86,-42,T,49
6752,Top Mid Arch Side,boltz,0,0,0,0,0,0,CT,49
6753,Top Mid Arch Side,boltz,1,1,0,184,100,84,T,49
6754,CT Peek Towards B Choke,boltz,2,1,1,173,127,46,CT,49
6755,CT Peek Towards B Choke,boltz,0,0,0,0,0,0,T,49
6756,Lane Side,boltz,0,0,0,0,0,0,CT,49
6757,Lane Side,boltz,0,2,-2,54,256,-202,T,49
6758,Arch Side,boltz,0,1,-1,0,70,-70,CT,49
6759,Arch Side,boltz,0,0,0,0,0,0,T,49
6760,CT Banana Sandbags Right Corner,boltz,0,0,0,16,11,5,CT,49
6761,CT Banana Sandbags Right Corner,boltz,0,0,0,0,0,0,T,49
6762,Construction,boltz,0,1,-1,49,100,-51,CT,49
6763,Construction,boltz,0,0,0,0,0,0,T,49
6764,Pit Peek Towards Lane,boltz,0,0,0,103,31,72,CT,49
6765,Pit Peek Towards Lane,boltz,0,1,-1,22,82,-60,T,49
6766,Dark,boltz,0,1,-1,78,100,-22,CT,49
6767,Dark,boltz,1,0,1,37,0,37,T,49
6768,Grill,boltz,0,0,0,0,0,0,CT,49
6769,Grill,boltz,0,1,-1,0,100,-100,T,49
6770,Default Plant A Site,boltz,0,0,0,0,0,0,CT,49
6771,Default Plant A Site,boltz,0,1,-1,0,100,-100,T,49
6772,Next to Library Cubby,boltz,0,1,-1,40,100,-60,CT,49
6773,Next to Library Cubby,boltz,0,0,0,0,0,0,T,49
6774,B Site Cross for T's Exposed to CT and Quad,boltz,0,0,0,5,0,5,CT,49
6775,B Site Cross for T's Exposed to CT and Quad,boltz,0,0,0,0,14,-14,T,49
6776,Lane Behind Pillar,boltz,0,0,0,0,0,0,CT,49
6777,Lane Behind Pillar,boltz,0,0,0,0,0,0,T,49
6778,Quad Box,boltz,0,1,-1,0,100,-100,CT,49
6779,Quad Box,boltz,0,0,0,0,0,0,T,49
6780,Deep Apps Past Hallway,boltz,0,0,0,0,0,0,CT,49
6781,Deep Apps Past Hallway,boltz,0,0,0,0,0,0,T,49
6782,CT Outside Construction,boltz,0,0,0,0,0,0,CT,49
6783,CT Outside Construction,boltz,0,0,0,0,0,0,T,49
6784,Deep CT Peeking Towards B Site,boltz,0,1,-1,20,60,-40,CT,49
6785,Deep CT Peeking Towards B Site,boltz,0,0,0,0,0,0,T,49
6786,B Site,boltz,0,0,0,0,0,0,CT,49
6787,B Site,boltz,0,0,0,27,0,27,T,49
6788,Logs,boltz,0,0,0,0,0,0,CT,49
6789,Logs,boltz,2,0,2,284,133,151,T,49
6790,Behind Coffins Playing the B Site Cross,boltz,2,1,1,246,117,129,CT,49
6791,Behind Coffins Playing the B Site Cross,boltz,0,0,0,0,0,0,T,49
6792,Pit,boltz,0,0,0,0,0,0,CT,49
6793,Pit,boltz,0,1,-1,0,27,-27,T,49
6794,CT Arch,boltz,0,0,0,0,0,0,CT,49
6795,CT Arch,boltz,0,0,0,0,0,0,T,49
6796,Top Mid Chokepoint,boltz,0,0,0,0,0,0,CT,49
6797,Top Mid Chokepoint,boltz,1,1,0,100,122,-22,T,49
6798,1st Oranges,boltz,0,1,-1,25,15,10,CT,49
6799,1st Oranges,boltz,0,0,0,0,0,0,T,49
6800,Middle,boltz,0,0,0,0,0,0,CT,49
6801,Middle,boltz,0,0,0,0,0,0,T,49
6802,Top Mid Lane Side ,boltz,0,0,0,0,0,0,CT,49
6803,Top Mid Lane Side ,boltz,0,1,-1,0,78,-78,T,49
6804,Top Balcony ,boltz,0,0,0,0,0,0,CT,49
6805,Top Balcony ,boltz,0,1,-1,0,100,-100,T,49
6806,Pit Below Balcony,boltz,0,0,0,0,0,0,CT,49
6807,Pit Below Balcony,boltz,0,0,0,0,0,0,T,49
6808,2nd Oranges,boltz,1,0,1,73,85,-12,CT,49
6809,2nd Oranges,boltz,0,0,0,0,0,0,T,49
6810,T Ramp Peeking Towards Mid,boltz,0,0,0,0,0,0,CT,49
6811,T Ramp Peeking Towards Mid,boltz,1,1,0,128,103,25,T,49
6812,Banana,dexter,3,1,2,317,149,168,CT,51
6813,Banana,dexter,1,4,-3,177,448,-271,T,51
6814,CT Banana Half Wall Side,dexter,1,0,1,141,116,25,CT,51
6815,CT Banana Half Wall Side,dexter,0,3,-3,68,203,-135,T,51
6816,Chokepoint Entering B,dexter,1,2,-1,171,241,-70,CT,51
6817,Chokepoint Entering B,dexter,1,0,1,9,59,-50,T,51
6818,Construction,dexter,0,0,0,0,0,0,CT,51
6819,Construction,dexter,2,0,2,200,0,200,T,51
6820,Behind Coffins Playing the B Site Cross,dexter,0,0,0,0,0,0,CT,51
6821,Behind Coffins Playing the B Site Cross,dexter,2,1,1,82,100,-18,T,51
6822,CT Banana Sandbangs,dexter,0,1,-1,10,103,-93,CT,51
6823,CT Banana Sandbangs,dexter,2,0,2,226,18,208,T,51
6824,Lane Side,dexter,0,0,0,46,0,46,CT,51
6825,Lane Side,dexter,0,1,-1,0,59,-59,T,51
6826,CT Peek Towards B Choke,dexter,1,1,0,100,100,0,CT,51
6827,CT Peek Towards B Choke,dexter,1,0,1,100,0,100,T,51
6828,Boiler Side Stairs,dexter,0,0,0,0,0,0,CT,51
6829,Boiler Side Stairs,dexter,1,1,0,15,59,-44,T,51
6830,CT Banana Sandbags Right Corner,dexter,0,1,-1,0,5,-5,CT,51
6831,CT Banana Sandbags Right Corner,dexter,0,0,0,0,0,0,T,51
6832,Bottom Mid Banana,dexter,0,1,-1,0,14,-14,CT,51
6833,Bottom Mid Banana,dexter,0,1,-1,9,228,-219,T,51
6834,Outside Library,dexter,0,2,-2,78,147,-69,CT,51
6835,Outside Library,dexter,0,0,0,0,0,0,T,51
6836,Logs,dexter,2,0,2,147,44,103,CT,51
6837,Logs,dexter,0,0,0,51,0,51,T,51
6838,B Site Cross for T's Exposed to CT and Quad,dexter,0,0,0,0,0,0,CT,51
6839,B Site Cross for T's Exposed to CT and Quad,dexter,0,0,0,0,0,0,T,51
6840,Pit Below Balcony,dexter,0,0,0,0,0,0,CT,51
6841,Pit Below Balcony,dexter,0,0,0,0,0,0,T,51
6842,A Site,dexter,0,1,-1,0,22,-22,CT,51
6843,A Site,dexter,0,0,0,0,0,0,T,51
6844,Boiler Peek to Mid,dexter,0,0,0,0,0,0,CT,51
6845,Boiler Peek to Mid,dexter,0,1,-1,12,100,-88,T,51
6846,CT Banana Barrels,dexter,0,1,-1,22,100,-78,CT,51
6847,CT Banana Barrels,dexter,0,0,0,0,0,0,T,51
6848,1st Oranges,dexter,0,1,-1,50,89,-39,CT,51
6849,1st Oranges,dexter,0,0,0,0,0,0,T,51
6850,CT Outside Kitchen,dexter,0,0,0,0,0,0,CT,51
6851,CT Outside Kitchen,dexter,0,1,-1,0,100,-100,T,51
6852,Behind B Site Back Pillar,dexter,0,1,-1,87,100,-13,CT,51
6853,Behind B Site Back Pillar,dexter,0,0,0,0,0,0,T,51
6854,CT Outside Construction,dexter,0,0,0,0,0,0,CT,51
6855,CT Outside Construction,dexter,0,0,0,0,0,0,T,51
6856,Deep CT Peeking Towards B Site,dexter,0,0,0,22,0,22,CT,51
6857,Deep CT Peeking Towards B Site,dexter,0,0,0,0,0,0,T,51
6858,Top Mid Arch Side,dexter,0,0,0,0,0,0,CT,51
6859,Top Mid Arch Side,dexter,0,1,-1,88,58,30,T,51
6860,Bottom Mid exposed to Top Mid,dexter,0,0,0,0,53,-53,CT,51
6861,Bottom Mid exposed to Top Mid,dexter,0,1,-1,0,46,-46,T,51
6862,CT Boost,dexter,0,1,-1,0,73,-73,CT,51
6863,CT Boost,dexter,0,0,0,0,0,0,T,51
6864,Top Mid Chokepoint,dexter,0,1,-1,0,48,-48,CT,51
6865,Top Mid Chokepoint,dexter,0,0,0,0,25,-25,T,51
6866,TopofMid,dexter,0,0,0,0,0,0,CT,51
6867,TopofMid,dexter,0,1,-1,0,100,-100,T,51
6868,Middle,dexter,0,0,0,0,0,0,CT,51
6869,Middle,dexter,0,0,0,0,0,0,T,51
6870,Top Mid Lane Side ,dexter,3,0,3,338,85,253,CT,51
6871,Top Mid Lane Side ,dexter,0,1,-1,68,141,-73,T,51
6872,Apps T Side Stairs,dexter,0,0,0,0,0,0,CT,51
6873,Apps T Side Stairs,dexter,0,1,-1,0,100,-100,T,51
6874,CT Arch,dexter,0,0,0,0,0,0,CT,51
6875,CT Arch,dexter,0,1,-1,0,100,-100,T,51
6876,Top Mid Chokepoint,JW,0,1,-1,15,100,-85,CT,48
6877,Top Mid Chokepoint,JW,0,2,-2,0,264,-264,T,48
6878,CT Peek Towards B Choke,JW,1,3,-2,167,361,-194,CT,48
6879,CT Peek Towards B Choke,JW,0,0,0,0,29,-29,T,48
6880,B Site,JW,0,1,-1,28,39,-11,CT,48
6881,B Site,JW,0,1,-1,0,90,-90,T,48
6882,A Site,JW,1,1,0,100,100,0,CT,48
6883,A Site,JW,0,0,0,0,0,0,T,48
6884,Construction,JW,0,1,-1,0,66,-66,CT,48
6885,Construction,JW,0,1,-1,0,100,-100,T,48
6886,Top Mid Arch Side,JW,0,0,0,0,0,0,CT,48
6887,Top Mid Arch Side,JW,0,0,0,0,0,0,T,48
6888,Apps T Side Stairs,JW,0,1,-1,0,100,-100,CT,48
6889,Apps T Side Stairs,JW,0,1,-1,0,100,-100,T,48
6890,Banana,JW,0,1,-1,0,100,-100,CT,48
6891,Banana,JW,0,0,0,0,26,-26,T,48
6892,Pit Peek Towards Lane,JW,0,1,-1,0,46,-46,CT,48
6893,Pit Peek Towards Lane,JW,0,1,-1,0,13,-13,T,48
6894,Middle,JW,0,0,0,0,0,0,CT,48
6895,Middle,JW,0,1,-1,0,92,-92,T,48
6896,Lane Side,JW,2,0,2,158,0,158,CT,48
6897,Lane Side,JW,0,0,0,0,0,0,T,48
6898,Deep CT Peeking Towards B Site,JW,1,2,-1,171,286,-115,CT,48
6899,Deep CT Peeking Towards B Site,JW,0,0,0,0,0,0,T,48
6900,Chokepoint Entering B,JW,3,0,3,208,60,148,CT,48
6901,Chokepoint Entering B,JW,0,0,0,0,0,0,T,48
6902,A Site Behind Default Boxes,JW,0,2,-2,0,124,-124,CT,48
6903,A Site Behind Default Boxes,JW,0,0,0,0,13,-13,T,48
6904,Graveyard Stairs,JW,0,0,0,0,0,0,CT,48
6905,Graveyard Stairs,JW,0,0,0,0,0,0,T,48
6906,Grill,JW,0,0,0,0,0,0,CT,48
6907,Grill,JW,1,1,0,77,100,-23,T,48
6908,CT Banana Barrels,JW,0,1,-1,0,100,-100,CT,48
6909,CT Banana Barrels,JW,0,0,0,0,8,-8,T,48
6910,1st Oranges,JW,0,0,0,0,0,0,CT,48
6911,1st Oranges,JW,0,0,0,0,0,0,T,48
6912,Chokepoint Entrance onto A site from Library Side,JW,1,0,1,100,0,100,CT,48
6913,Chokepoint Entrance onto A site from Library Side,JW,0,1,-1,0,100,-100,T,48
6914,Outside Library,JW,0,0,0,0,0,0,CT,48
6915,Outside Library,JW,0,0,0,0,0,0,T,48
6916,Deep Apps Past Hallway,JW,0,0,0,0,0,0,CT,48
6917,Deep Apps Past Hallway,JW,0,0,0,0,0,0,T,48
6918,A Bombsite Close Left,JW,1,0,1,122,0,122,CT,48
6919,A Bombsite Close Left,JW,0,1,-1,0,102,-102,T,48
6920,Back Alley,JW,0,1,-1,21,100,-79,CT,48
6921,Back Alley,JW,0,0,0,0,0,0,T,48
6922,Arch Side Cubby,JW,0,1,-1,0,50,-50,CT,48
6923,Arch Side Cubby,JW,0,0,0,0,0,0,T,48
6924,Behind Coffins Playing the B Site Cross,JW,0,0,0,72,34,38,CT,48
6925,Behind Coffins Playing the B Site Cross,JW,0,0,0,0,0,0,T,48
6926,CT Banana Half Wall Side,JW,0,0,0,0,0,0,CT,48
6927,CT Banana Half Wall Side,JW,0,0,0,0,40,-40,T,48
6928,Boiler Side Stairs,JW,0,0,0,0,0,0,CT,48
6929,Boiler Side Stairs,JW,0,1,-1,0,0,0,T,48
6930,CT Banana Sandbags Right Corner,JW,0,0,0,0,0,0,CT,48
6931,CT Banana Sandbags Right Corner,JW,0,0,0,0,0,0,T,48
6932,A Site Behind Middle Boxes/Pillar hidden from Lane,JW,0,0,0,0,16,-16,CT,48
6933,A Site Behind Middle Boxes/Pillar hidden from Lane,JW,0,0,0,0,0,0,T,48
6934,TopofMid,JW,0,0,0,0,0,0,CT,48
6935,TopofMid,JW,0,0,0,0,0,0,T,48
6936,Top Mid Lane Side ,JW,1,0,1,100,0,100,CT,48
6937,Top Mid Lane Side ,JW,1,1,0,73,100,-27,T,48
6938,Top Balcony ,JW,0,0,0,0,0,0,CT,48
6939,Top Balcony ,JW,1,1,0,41,100,-59,T,48
6940,Arch Side,JW,1,0,1,135,104,31,CT,48
6941,Arch Side,JW,0,1,-1,0,100,-100,T,48
6942,A Bombsite Back Site,JW,0,1,-1,0,81,-81,CT,48
6943,A Bombsite Back Site,JW,0,0,0,0,0,0,T,48
6944,Apps Hallway,JW,0,0,0,0,0,0,CT,48
6945,Apps Hallway,JW,0,0,0,0,0,0,T,48
6946,Right Side Quadbox Peek for a CT,JW,0,0,0,0,0,0,CT,48
6947,Right Side Quadbox Peek for a CT,JW,0,0,0,0,0,0,T,48
6948,CT Banana Half Wall Side,Golden,1,2,-1,207,371,-164,CT,48
6949,CT Banana Half Wall Side,Golden,0,1,-1,0,99,-99,T,48
6950,Chokepoint Entering B,Golden,1,3,-2,285,336,-51,CT,48
6951,Chokepoint Entering B,Golden,0,0,0,0,0,0,T,48
6952,CT Peek Towards B Choke,Golden,0,2,-2,0,140,-140,CT,48
6953,CT Peek Towards B Choke,Golden,0,1,-1,0,100,-100,T,48
6954,Banana,Golden,0,1,-1,43,55,-12,CT,48
6955,Banana,Golden,0,2,-2,108,223,-115,T,48
6956,Top Mid Chokepoint,Golden,0,0,0,61,5,56,CT,48
6957,Top Mid Chokepoint,Golden,1,3,-2,155,276,-121,T,48
6958,1st Oranges,Golden,0,1,-1,0,100,-100,CT,48
6959,1st Oranges,Golden,0,1,-1,15,100,-85,T,48
6960,A Bombsite Close Left,Golden,0,2,-2,51,104,-53,CT,48
6961,A Bombsite Close Left,Golden,0,0,0,0,0,0,T,48
6962,B Site,Golden,0,1,-1,91,103,-12,CT,48
6963,B Site,Golden,0,1,-1,68,115,-47,T,48
6964,Behind Coffins Playing the B Site Cross,Golden,0,1,-1,20,20,0,CT,48
6965,Behind Coffins Playing the B Site Cross,Golden,0,1,-1,0,39,-39,T,48
6966,Fountain,Golden,0,1,-1,0,100,-100,CT,48
6967,Fountain,Golden,0,0,0,0,0,0,T,48
6968,Pit Below Balcony,Golden,0,0,0,0,0,0,CT,48
6969,Pit Below Balcony,Golden,0,0,0,0,0,0,T,48
6970,A Site Behind Default Boxes,Golden,0,0,0,0,0,0,CT,48
6971,A Site Behind Default Boxes,Golden,1,1,0,4,100,-96,T,48
6972,B Site Cross for T's Exposed to CT and Quad,Golden,1,1,0,132,85,47,CT,48
6973,B Site Cross for T's Exposed to CT and Quad,Golden,0,0,0,0,24,-24,T,48
6974,Behind B Site Back Pillar,Golden,0,1,-1,55,100,-45,CT,48
6975,Behind B Site Back Pillar,Golden,0,0,0,0,0,0,T,48
6976,Middle,Golden,0,1,-1,16,95,-79,CT,48
6977,Middle,Golden,0,0,0,8,0,8,T,48
6978,Grill,Golden,0,0,0,0,0,0,CT,48
6979,Grill,Golden,1,1,0,85,157,-72,T,48
6980,T Ramp Peeking Towards Mid,Golden,0,0,0,0,0,0,CT,48
6981,T Ramp Peeking Towards Mid,Golden,0,1,-1,38,100,-62,T,48
6982,Lane Side,Golden,0,0,0,0,0,0,CT,48
6983,Lane Side,Golden,0,0,0,0,0,0,T,48
6984,Left Side Quadbox Peek for a CT,Golden,1,1,0,100,38,62,CT,48
6985,Left Side Quadbox Peek for a CT,Golden,0,0,0,0,0,0,T,48
6986,CT Banana Sandbangs,Golden,1,1,0,34,123,-89,CT,48
6987,CT Banana Sandbangs,Golden,0,0,0,0,0,0,T,48
6988,Construction,Golden,0,1,-1,0,58,-58,CT,48
6989,Construction,Golden,1,0,1,99,27,72,T,48
6990,Lane Patio,Golden,0,0,0,0,0,0,CT,48
6991,Lane Patio,Golden,0,0,0,0,0,0,T,48
6992,Right Side Quadbox Peek for a CT,Golden,1,1,0,154,100,54,CT,48
6993,Right Side Quadbox Peek for a CT,Golden,0,0,0,0,0,0,T,48
6994,Library,Golden,1,0,1,31,0,31,CT,48
6995,Library,Golden,1,0,1,100,0,100,T,48
6996,CT Outside Arch,Golden,0,0,0,0,0,0,CT,48
6997,CT Outside Arch,Golden,0,0,0,0,0,0,T,48
6998,Top Coffins,Golden,0,1,-1,0,94,-94,CT,48
6999,Top Coffins,Golden,0,0,0,0,0,0,T,48
7000,Quad Box,Golden,1,1,0,61,153,-92,CT,48
7001,Quad Box,Golden,0,0,0,0,0,0,T,48
7002,Top Balcony ,Golden,0,0,0,0,0,0,CT,48
7003,Top Balcony ,Golden,0,0,0,0,0,0,T,48
7004,Apps T Side Stairs,Golden,0,0,0,0,0,0,CT,48
7005,Apps T Side Stairs,Golden,0,0,0,0,0,0,T,48
7006,CT Speed Way,Golden,0,0,0,0,0,0,CT,48
7007,CT Speed Way,Golden,0,0,0,0,0,0,T,48
7008,Arch Side,Golden,0,0,0,0,0,0,CT,48
7009,Arch Side,Golden,0,0,0,0,0,0,T,48
7010,CT Banana Close Left Half Wall,Golden,0,1,-1,0,100,-100,CT,48
7011,CT Banana Close Left Half Wall,Golden,0,0,0,0,0,0,T,48
7012,A Site Right Side Middle Pillar,Golden,0,0,0,0,0,0,CT,48
7013,A Site Right Side Middle Pillar,Golden,0,1,-1,0,94,-94,T,48
7014,Top Mid Lane Side ,yeL,1,2,-1,80,228,-148,CT,49
7015,Top Mid Lane Side ,yeL,0,1,-1,0,100,-100,T,49
7016,Banana,yeL,0,0,0,0,0,0,CT,49
7017,Banana,yeL,4,4,0,570,419,151,T,49
7018,B Site,yeL,1,1,0,87,100,-13,CT,49
7019,B Site,yeL,0,1,-1,0,22,-22,T,49
7020,Chokepoint Entering B,yeL,1,0,1,102,0,102,CT,49
7021,Chokepoint Entering B,yeL,1,1,0,25,73,-48,T,49
7022,Top Balcony ,yeL,0,2,-2,0,151,-151,CT,49
7023,Top Balcony ,yeL,1,1,0,53,100,-47,T,49
7024,Top Mid Arch Side,yeL,0,0,0,3,0,3,CT,49
7025,Top Mid Arch Side,yeL,0,1,-1,24,100,-76,T,49
7026,CT Banana Half Wall Side,yeL,0,2,-2,16,179,-163,CT,49
7027,CT Banana Half Wall Side,yeL,1,0,1,62,0,62,T,49
7028,Lane Side,yeL,2,1,1,213,132,81,CT,49
7029,Lane Side,yeL,0,1,-1,0,100,-100,T,49
7030,B Site Cross for T's Exposed to CT and Quad,yeL,0,1,-1,0,100,-100,CT,49
7031,B Site Cross for T's Exposed to CT and Quad,yeL,0,1,-1,0,100,-100,T,49
7032,Boiler Peek to Mid,yeL,0,0,0,0,6,-6,CT,49
7033,Boiler Peek to Mid,yeL,0,0,0,0,0,0,T,49
7034,CT Banana Sandbags Right Corner,yeL,0,0,0,0,0,0,CT,49
7035,CT Banana Sandbags Right Corner,yeL,0,1,-1,33,204,-171,T,49
7036,Top Mid Chokepoint,yeL,0,0,0,0,0,0,CT,49
7037,Top Mid Chokepoint,yeL,0,1,-1,0,109,-109,T,49
7038,CT Banana Barrels,yeL,0,0,0,0,0,0,CT,49
7039,CT Banana Barrels,yeL,0,0,0,0,0,0,T,49
7040,Top Graveyard,yeL,0,1,-1,0,100,-100,CT,49
7041,Top Graveyard,yeL,0,0,0,0,0,0,T,49
7042,Pit Peek Towards Lane,yeL,0,0,0,0,49,-49,CT,49
7043,Pit Peek Towards Lane,yeL,0,0,0,0,0,0,T,49
7044,CT Outside Kitchen,yeL,0,0,0,0,0,0,CT,49
7045,CT Outside Kitchen,yeL,0,1,-1,0,30,-30,T,49
7046,A Bombsite Close Left,yeL,0,1,-1,38,115,-77,CT,49
7047,A Bombsite Close Left,yeL,0,0,0,0,0,0,T,49
7048,CT Banana Sandbangs,yeL,0,0,0,0,0,0,CT,49
7049,CT Banana Sandbangs,yeL,0,0,0,0,0,0,T,49
7050,Top Hay Bales,yeL,0,1,-1,0,100,-100,CT,49
7051,Top Hay Bales,yeL,0,0,0,0,0,0,T,49
7052,Right Side Quadbox Peek for a CT,yeL,0,0,0,0,0,0,CT,49
7053,Right Side Quadbox Peek for a CT,yeL,0,0,0,0,0,0,T,49
7054,Behind Coffins Playing the B Site Cross,yeL,1,1,0,100,100,0,CT,49
7055,Behind Coffins Playing the B Site Cross,yeL,0,0,0,0,0,0,T,49
7056,CT Peek Towards B Choke,yeL,0,1,-1,27,100,-73,CT,49
7057,CT Peek Towards B Choke,yeL,0,0,0,0,0,0,T,49
7058,Bottom Mid exposed to Top Mid,yeL,0,0,0,0,0,0,CT,49
7059,Bottom Mid exposed to Top Mid,yeL,0,1,-1,0,100,-100,T,49
7060,Top Coffins,yeL,0,0,0,0,0,0,CT,49
7061,Top Coffins,yeL,0,0,0,0,0,0,T,49
7062,Apps Hallway,yeL,0,0,0,0,0,0,CT,49
7063,Apps Hallway,yeL,0,1,-1,0,84,-84,T,49
7064,SecondMid,yeL,0,0,0,0,0,0,CT,49
7065,SecondMid,yeL,0,1,-1,82,100,-18,T,49
7066,Arch Side Cubby,yeL,1,1,0,58,100,-42,CT,49
7067,Arch Side Cubby,yeL,0,0,0,0,0,0,T,49
7068,Graveyard Stairs,yeL,0,0,0,0,0,0,CT,49
7069,Graveyard Stairs,yeL,0,0,0,0,0,0,T,49
7070,Pit Below Balcony,yeL,0,0,0,0,0,0,CT,49
7071,Pit Below Balcony,yeL,0,1,-1,0,90,-90,T,49
7072,Construction Sandbags,yeL,0,1,-1,16,100,-84,CT,49
7073,Construction Sandbags,yeL,0,0,0,0,0,0,T,49
7074,T Ramp Peeking Towards Mid,yeL,0,0,0,0,0,0,CT,49
7075,T Ramp Peeking Towards Mid,yeL,0,1,-1,0,126,-126,T,49
7076,Top Mid Chokepoint,Bymas,0,0,0,0,0,0,CT,51
7077,Top Mid Chokepoint,Bymas,0,4,-4,49,242,-193,T,51
7078,Banana,Bymas,0,0,0,0,0,0,CT,51
7079,Banana,Bymas,3,3,0,367,434,-67,T,51
7080,B Site,Bymas,1,1,0,44,100,-56,CT,51
7081,B Site,Bymas,1,0,1,100,0,100,T,51
7082,Pit Below Balcony,Bymas,2,3,-1,266,300,-34,CT,51
7083,Pit Below Balcony,Bymas,0,0,0,0,0,0,T,51
7084,Lane Side,Bymas,1,1,0,78,64,14,CT,51
7085,Lane Side,Bymas,0,1,-1,0,82,-82,T,51
7086,Grill,Bymas,0,0,0,0,0,0,CT,51
7087,Grill,Bymas,2,1,1,234,100,134,T,51
7088,A Site Behind Default Boxes,Bymas,1,2,-1,185,200,-15,CT,51
7089,A Site Behind Default Boxes,Bymas,0,0,0,0,0,0,T,51
7090,CT Banana Half Wall Side,Bymas,0,0,0,0,0,0,CT,51
7091,CT Banana Half Wall Side,Bymas,0,1,-1,0,178,-178,T,51
7092,Behind Coffins Playing the B Site Cross,Bymas,1,1,0,58,100,-42,CT,51
7093,Behind Coffins Playing the B Site Cross,Bymas,1,0,1,185,0,185,T,51
7094,Top Mid Lane Side ,Bymas,0,0,0,84,4,80,CT,51
7095,Top Mid Lane Side ,Bymas,0,1,-1,0,100,-100,T,51
7096,Arch Side,Bymas,0,0,0,0,0,0,CT,51
7097,Arch Side,Bymas,1,1,0,195,149,46,T,51
7098,Apartments Hallway Peek from T Side,Bymas,0,1,-1,40,100,-60,CT,51
7099,Apartments Hallway Peek from T Side,Bymas,0,0,0,0,0,0,T,51
7100,Pit Peek Towards Lane,Bymas,0,0,0,0,0,0,CT,51
7101,Pit Peek Towards Lane,Bymas,0,0,0,0,0,0,T,51
7102,Underpass,Bymas,0,0,0,0,0,0,CT,51
7103,Underpass,Bymas,0,0,0,0,0,0,T,51
7104,Deep Apps Past Hallway,Bymas,0,0,0,0,0,0,CT,51
7105,Deep Apps Past Hallway,Bymas,0,0,0,0,0,0,T,51
7106,CT Outside Construction,Bymas,0,1,-1,0,100,-100,CT,51
7107,CT Outside Construction,Bymas,0,0,0,0,0,0,T,51
7108,A Site Right Side Middle Pillar,Bymas,0,0,0,0,0,0,CT,51
7109,A Site Right Side Middle Pillar,Bymas,0,0,0,0,0,0,T,51
7110,B Site Cross for T's Exposed to CT and Quad,Bymas,0,0,0,0,0,0,CT,51
7111,B Site Cross for T's Exposed to CT and Quad,Bymas,0,1,-1,0,88,-88,T,51
7112,Boiler Peek to Mid,Bymas,0,0,0,0,0,0,CT,51
7113,Boiler Peek to Mid,Bymas,0,0,0,0,0,0,T,51
7114,CT Outside Arch,Bymas,0,0,0,0,0,0,CT,51
7115,CT Outside Arch,Bymas,1,1,0,80,97,-17,T,51
7116,Logs,Bymas,0,0,0,0,0,0,CT,51
7117,Logs,Bymas,0,1,-1,67,107,-40,T,51
7118,Apartments,Bymas,0,1,-1,70,100,-30,CT,51
7119,Apartments,Bymas,0,0,0,0,0,0,T,51
7120,Deep CT Peeking Towards B Site,Bymas,0,1,-1,0,100,-100,CT,51
7121,Deep CT Peeking Towards B Site,Bymas,0,0,0,0,0,0,T,51
7122,Outside Library,Bymas,0,0,0,30,0,30,CT,51
7123,Outside Library,Bymas,0,0,0,0,0,0,T,51
7124,Bottom Mid exposed to Top Mid,Bymas,0,0,0,0,0,0,CT,51
7125,Bottom Mid exposed to Top Mid,Bymas,0,1,-1,0,100,-100,T,51
7126,CT Outside Kitchen,Bymas,0,0,0,0,0,0,CT,51
7127,CT Outside Kitchen,Bymas,0,0,0,0,0,0,T,51
7128,Front Coffins,Bymas,0,0,0,0,0,0,CT,51
7129,Front Coffins,Bymas,0,0,0,0,0,0,T,51
7130,CT Banana Sandbags Right Corner,Bymas,0,0,0,0,0,0,CT,51
7131,CT Banana Sandbags Right Corner,Bymas,0,1,-1,35,100,-65,T,51
7132,Quad Box,Bymas,0,0,0,0,0,0,CT,51
7133,Quad Box,Bymas,0,0,0,0,0,0,T,51
7134,CT Peek Towards B Choke,Bymas,0,0,0,0,0,0,CT,51
7135,CT Peek Towards B Choke,Bymas,1,0,1,100,15,85,T,51
7136,Chokepoint Entering B,Bymas,1,0,1,45,0,45,CT,51
7137,Chokepoint Entering B,Bymas,0,1,-1,0,100,-100,T,51
7138,Left Side Quadbox Peek for a CT,Bymas,0,0,0,0,0,0,CT,51
7139,Left Side Quadbox Peek for a CT,Bymas,0,0,0,0,0,0,T,51
7140,CT Banana Barrels,Bymas,0,0,0,0,0,0,CT,51
7141,CT Banana Barrels,Bymas,0,0,0,0,0,0,T,51
7142,Top Mid Arch Side,danoco,0,0,0,77,0,77,CT,49
7143,Top Mid Arch Side,danoco,1,3,-2,153,298,-145,T,49
7144,Outside Library,danoco,0,2,-2,120,178,-58,CT,49
7145,Outside Library,danoco,0,1,-1,0,78,-78,T,49
7146,Chokepoint Entering B,danoco,2,0,2,211,30,181,CT,49
7147,Chokepoint Entering B,danoco,0,2,-2,12,246,-234,T,49
7148,Top Mid Lane Side ,danoco,0,0,0,0,0,0,CT,49
7149,Top Mid Lane Side ,danoco,1,2,-1,100,200,-100,T,49
7150,Boiler Room,danoco,1,0,1,100,0,100,CT,49
7151,Boiler Room,danoco,0,0,0,0,0,0,T,49
7152,CT Peek Towards B Choke,danoco,2,2,0,138,134,4,CT,49
7153,CT Peek Towards B Choke,danoco,0,0,0,0,0,0,T,49
7154,CT Banana Half Wall Side,danoco,0,0,0,0,0,0,CT,49
7155,CT Banana Half Wall Side,danoco,0,2,-2,52,106,-54,T,49
7156,Top Mid Chokepoint,danoco,0,0,0,0,0,0,CT,49
7157,Top Mid Chokepoint,danoco,0,2,-2,0,202,-202,T,49
7158,B Site,danoco,0,1,-1,14,58,-44,CT,49
7159,B Site,danoco,0,0,0,0,0,0,T,49
7160,CT Arch,danoco,1,1,0,104,100,4,CT,49
7161,CT Arch,danoco,0,0,0,0,0,0,T,49
7162,B Site Cross for T's Exposed to CT and Quad,danoco,1,1,0,19,100,-81,CT,49
7163,B Site Cross for T's Exposed to CT and Quad,danoco,0,0,0,0,0,0,T,49
7164,Deep Apps Past Hallway,danoco,0,0,0,0,0,0,CT,49
7165,Deep Apps Past Hallway,danoco,0,0,0,0,0,0,T,49
7166,Arch Side,danoco,1,0,1,156,44,112,CT,49
7167,Arch Side,danoco,0,2,-2,0,147,-147,T,49
7168,Boiler Side Stairs,danoco,0,1,-1,10,127,-117,CT,49
7169,Boiler Side Stairs,danoco,0,0,0,0,0,0,T,49
7170,Default Plant A Site,danoco,0,0,0,0,0,0,CT,49
7171,Default Plant A Site,danoco,1,1,0,100,100,0,T,49
7172,CT Outside Construction,danoco,0,1,-1,0,83,-83,CT,49
7173,CT Outside Construction,danoco,0,0,0,0,0,0,T,49
7174,Boiler Peek to Mid,danoco,1,0,1,100,0,100,CT,49
7175,Boiler Peek to Mid,danoco,0,1,-1,0,100,-100,T,49
7176,Next to Library Cubby,danoco,0,0,0,0,36,-36,CT,49
7177,Next to Library Cubby,danoco,1,0,1,113,0,113,T,49
7178,Lane Patio,danoco,0,0,0,0,0,0,CT,49
7179,Lane Patio,danoco,0,0,0,0,0,0,T,49
7180,Grill,danoco,1,1,0,78,100,-22,CT,49
7181,Grill,danoco,0,0,0,0,0,0,T,49
7182,A Bombsite Close Left,danoco,0,0,0,0,0,0,CT,49
7183,A Bombsite Close Left,danoco,0,1,-1,0,90,-90,T,49
7184,Front Coffins,danoco,0,0,0,0,0,0,CT,49
7185,Front Coffins,danoco,0,1,-1,0,76,-76,T,49
7186,A Site,danoco,0,1,-1,0,15,-15,CT,49
7187,A Site,danoco,0,0,0,0,0,0,T,49
7188,Behind Coffins Playing the B Site Cross,danoco,0,0,0,11,42,-31,CT,49
7189,Behind Coffins Playing the B Site Cross,danoco,0,0,0,0,0,0,T,49
7190,Underpass,danoco,0,0,0,0,0,0,CT,49
7191,Underpass,danoco,0,0,0,0,0,0,T,49
7192,Pit Peek Towards Lane,danoco,1,1,0,140,100,40,CT,49
7193,Pit Peek Towards Lane,danoco,1,0,1,100,0,100,T,49
7194,Bottom Mid Banana,danoco,0,1,-1,0,100,-100,CT,49
7195,Bottom Mid Banana,danoco,0,0,0,0,0,0,T,49
7196,CT Banana Sandbags Right Corner,danoco,0,0,0,0,0,0,CT,49
7197,CT Banana Sandbags Right Corner,danoco,0,1,-1,0,34,-34,T,49
7198,A Site Behind Middle Boxes/Pillar hidden from Lane,danoco,0,1,-1,72,100,-28,CT,49
7199,A Site Behind Middle Boxes/Pillar hidden from Lane,danoco,0,0,0,0,0,0,T,49
7200,Lane Side,danoco,0,0,0,0,12,-12,CT,49
7201,Lane Side,danoco,0,1,-1,42,110,-68,T,49
7202,A Bombsite Back Site,danoco,0,0,0,0,0,0,CT,49
7203,A Bombsite Back Site,danoco,0,0,0,0,0,0,T,49
7204,CT Banana Sandbangs,danoco,0,1,-1,34,86,-52,CT,49
7205,CT Banana Sandbangs,danoco,0,0,0,69,20,49,T,49
7206,Chokepoint Entering B,nexa,0,0,0,42,2,40,CT,59
7207,Chokepoint Entering B,nexa,2,5,-3,200,474,-274,T,59
7208,Lane Side,nexa,1,1,0,32,100,-68,CT,59
7209,Lane Side,nexa,0,1,-1,0,98,-98,T,59
7210,Banana,nexa,1,1,0,110,93,17,CT,59
7211,Banana,nexa,1,2,-1,173,265,-92,T,59
7212,Pit,nexa,0,0,0,0,0,0,CT,59
7213,Pit,nexa,0,1,-1,0,100,-100,T,59
7214,Bottom Mid exposed to Top Mid,nexa,0,0,0,0,0,0,CT,59
7215,Bottom Mid exposed to Top Mid,nexa,0,1,-1,0,100,-100,T,59
7216,Top Balcony ,nexa,0,0,0,0,0,0,CT,59
7217,Top Balcony ,nexa,1,2,-1,28,152,-124,T,59
7218,B Site Cross for T's Exposed to CT and Quad,nexa,0,0,0,0,0,0,CT,59
7219,B Site Cross for T's Exposed to CT and Quad,nexa,0,2,-2,48,195,-147,T,59
7220,A Bombsite Close Left,nexa,0,0,0,0,0,0,CT,59
7221,A Bombsite Close Left,nexa,0,1,-1,64,100,-36,T,59
7222,Pit Peek Towards Lane,nexa,0,0,0,0,0,0,CT,59
7223,Pit Peek Towards Lane,nexa,0,0,0,0,0,0,T,59
7224,CT Banana Half Wall Side,nexa,0,0,0,72,69,3,CT,59
7225,CT Banana Half Wall Side,nexa,1,1,0,111,101,10,T,59
7226,Top Mid Lane Side ,nexa,0,0,0,0,0,0,CT,59
7227,Top Mid Lane Side ,nexa,1,2,-1,100,200,-100,T,59
7228,CT Boost,nexa,1,1,0,22,100,-78,CT,59
7229,CT Boost,nexa,0,0,0,0,0,0,T,59
7230,CT Banana Barrels,nexa,0,0,0,0,0,0,CT,59
7231,CT Banana Barrels,nexa,0,1,-1,0,100,-100,T,59
7232,Deep Apps Past Hallway,nexa,0,0,0,0,0,0,CT,59
7233,Deep Apps Past Hallway,nexa,0,1,-1,16,17,-1,T,59
7234,CT Outside Construction,nexa,0,0,0,0,0,0,CT,59
7235,CT Outside Construction,nexa,0,0,0,0,0,0,T,59
7236,2nd Oranges,nexa,0,0,0,0,0,0,CT,59
7237,2nd Oranges,nexa,0,0,0,0,0,0,T,59
7238,Default Plant A Site,nexa,1,1,0,22,98,-76,CT,59
7239,Default Plant A Site,nexa,0,0,0,0,0,0,T,59
7240,Dumpster,nexa,0,1,-1,0,19,-19,CT,59
7241,Dumpster,nexa,0,0,0,0,0,0,T,59
7242,CT Banana Sandbangs,nexa,0,0,0,0,3,-3,CT,59
7243,CT Banana Sandbangs,nexa,0,0,0,0,0,0,T,59
7244,Outside Library,nexa,1,0,1,18,0,18,CT,59
7245,Outside Library,nexa,0,1,-1,79,99,-20,T,59
7246,Chokepoint Entrance onto A site from Library Side,nexa,0,0,0,0,0,0,CT,59
7247,Chokepoint Entrance onto A site from Library Side,nexa,0,1,-1,0,100,-100,T,59
7248,Arch Side CT Corner Peeking Towards Top Mid,nexa,0,1,-1,0,40,-40,CT,59
7249,Arch Side CT Corner Peeking Towards Top Mid,nexa,0,0,0,0,0,0,T,59
7250,A Site Behind Default Boxes,nexa,0,1,-1,9,6,3,CT,59
7251,A Site Behind Default Boxes,nexa,0,0,0,0,0,0,T,59
7252,Front Coffins,nexa,0,0,0,0,0,0,CT,59
7253,Front Coffins,nexa,0,1,-1,0,144,-144,T,59
7254,Next to Library Cubby,nexa,0,0,0,82,0,82,CT,59
7255,Next to Library Cubby,nexa,0,0,0,0,0,0,T,59
7256,Behind Coffins Playing the B Site Cross,nexa,0,1,-1,0,87,-87,CT,59
7257,Behind Coffins Playing the B Site Cross,nexa,0,0,0,0,0,0,T,59
7258,Arch Side,nexa,1,0,1,84,60,24,CT,59
7259,Arch Side,nexa,0,1,-1,0,72,-72,T,59
7260,Right Side Quadbox Peek for a CT,nexa,2,1,1,212,121,91,CT,59
7261,Right Side Quadbox Peek for a CT,nexa,0,0,0,0,0,0,T,59
7262,Bottom Mid Banana,nexa,0,0,0,0,0,0,CT,59
7263,Bottom Mid Banana,nexa,0,0,0,0,13,-13,T,59
7264,A Site Behind Middle Boxes/Pillar hidden from Lane,nexa,1,0,1,57,0,57,CT,59
7265,A Site Behind Middle Boxes/Pillar hidden from Lane,nexa,0,0,0,0,0,0,T,59
7266,Dark,nexa,1,0,1,116,0,116,CT,59
7267,Dark,nexa,0,0,0,0,0,0,T,59
7268,CT Peek Towards B Choke,nexa,0,0,0,28,0,28,CT,59
7269,CT Peek Towards B Choke,nexa,0,0,0,0,27,-27,T,59
7270,Pit Below Balcony,nexa,0,0,0,0,0,0,CT,59
7271,Pit Below Balcony,nexa,0,0,0,0,0,0,T,59
7272,A Bombsite Back Site,nexa,0,0,0,0,0,0,CT,59
7273,A Bombsite Back Site,nexa,1,1,0,186,65,121,T,59
7274,T Ramp Peeking Towards Mid,nexa,0,0,0,0,0,0,CT,59
7275,T Ramp Peeking Towards Mid,nexa,2,1,1,245,269,-24,T,59
7276,Default Plant A Site,shox,0,0,0,0,0,0,CT,30
7277,Default Plant A Site,shox,0,0,0,0,0,0,T,30
7278,B Site Cross for T's Exposed to CT and Quad,shox,0,0,0,0,0,0,CT,30
7279,B Site Cross for T's Exposed to CT and Quad,shox,2,1,1,95,105,-10,T,30
7280,A Bombsite Close Left,shox,4,1,3,206,100,106,CT,30
7281,A Bombsite Close Left,shox,0,0,0,0,0,0,T,30
7282,Arch Side,shox,1,0,1,30,27,3,CT,30
7283,Arch Side,shox,1,0,1,100,88,12,T,30
7284,2nd Oranges,shox,0,0,0,0,0,0,CT,30
7285,2nd Oranges,shox,0,0,0,0,0,0,T,30
7286,Pit Below Balcony,shox,0,0,0,0,0,0,CT,30
7287,Pit Below Balcony,shox,0,2,-2,0,174,-174,T,30
7288,A Site,shox,0,1,-1,27,100,-73,CT,30
7289,A Site,shox,0,0,0,0,0,0,T,30
7290,Top Mid Chokepoint,shox,0,0,0,0,0,0,CT,30
7291,Top Mid Chokepoint,shox,0,1,-1,0,78,-78,T,30
7292,Top Coffins,shox,0,1,-1,38,100,-62,CT,30
7293,Top Coffins,shox,0,0,0,0,0,0,T,30
7294,B Site,shox,1,1,0,100,100,0,CT,30
7295,B Site,shox,0,0,0,0,0,0,T,30
7296,Back Alley,shox,0,1,-1,61,100,-39,CT,30
7297,Back Alley,shox,0,0,0,0,0,0,T,30
7298,LowerMid,shox,0,1,-1,0,21,-21,CT,30
7299,LowerMid,shox,0,0,0,0,0,0,T,30
7300,Left Side Quadbox Peek for a CT,shox,0,0,0,0,0,0,CT,30
7301,Left Side Quadbox Peek for a CT,shox,0,1,-1,0,14,-14,T,30
7302,Pit,shox,0,0,0,0,0,0,CT,30
7303,Pit,shox,0,1,-1,0,100,-100,T,30
7304,Boiler Peek to Mid,shox,0,0,0,0,0,0,CT,30
7305,Boiler Peek to Mid,shox,0,0,0,0,0,0,T,30
7306,CT Outside Arch,shox,0,0,0,0,0,0,CT,30
7307,CT Outside Arch,shox,0,0,0,0,0,0,T,30
7308,Apartments,shox,1,0,1,100,0,100,CT,30
7309,Apartments,shox,0,0,0,0,0,0,T,30
7310,Chokepoint Entrance onto A site from Library Side,shox,0,1,-1,0,73,-73,CT,30
7311,Chokepoint Entrance onto A site from Library Side,shox,0,0,0,0,0,0,T,30
7312,Outside Library,shox,0,0,0,0,0,0,CT,30
7313,Outside Library,shox,0,1,-1,0,98,-98,T,30
7314,Bottom Mid exposed to Top Mid,shox,1,1,0,75,100,-25,CT,30
7315,Bottom Mid exposed to Top Mid,shox,0,0,0,0,0,0,T,30
7316,CT Banana Half Wall Side,shox,0,0,0,0,0,0,CT,30
7317,CT Banana Half Wall Side,shox,0,1,-1,40,130,-90,T,30
7318,Deep CT Peeking Towards B Site,shox,1,1,0,23,37,-14,CT,30
7319,Deep CT Peeking Towards B Site,shox,0,0,0,0,0,0,T,30
7320,Boiler Side Stairs,shox,1,0,1,100,16,84,CT,30
7321,Boiler Side Stairs,shox,0,0,0,0,0,0,T,30
7322,Top Mid Lane Side ,shox,1,0,1,100,0,100,CT,30
7323,Top Mid Lane Side ,shox,1,0,1,100,22,78,T,30
7324,Top Balcony ,shox,0,0,0,0,0,0,CT,30
7325,Top Balcony ,shox,0,0,0,0,0,0,T,30
7326,Lane Side,shox,1,0,1,100,62,38,CT,30
7327,Lane Side,shox,0,1,-1,51,100,-49,T,30
7328,T Ramp Peeking Towards Mid,shox,0,0,0,0,0,0,CT,30
7329,T Ramp Peeking Towards Mid,shox,0,1,-1,72,100,-28,T,30
7330,A Bombsite Close Left,ZywOo,0,1,-1,68,100,-32,CT,30
7331,A Bombsite Close Left,ZywOo,0,0,0,0,0,0,T,30
7332,CT Peek Towards B Choke,ZywOo,0,2,-2,0,154,-154,CT,30
7333,CT Peek Towards B Choke,ZywOo,1,1,0,76,53,23,T,30
7334,Banana,ZywOo,0,0,0,0,0,0,CT,30
7335,Banana,ZywOo,1,1,0,152,106,46,T,30
7336,Pit Peek Towards Lane,ZywOo,0,0,0,0,0,0,CT,30
7337,Pit Peek Towards Lane,ZywOo,0,1,-1,0,100,-100,T,30
7338,Apps T Side Stairs,ZywOo,0,0,0,0,0,0,CT,30
7339,Apps T Side Stairs,ZywOo,1,0,1,80,0,80,T,30
7340,Top Balcony ,ZywOo,0,0,0,0,0,0,CT,30
7341,Top Balcony ,ZywOo,0,1,-1,12,66,-54,T,30
7342,CT Banana Half Wall Side,ZywOo,0,0,0,0,4,-4,CT,30
7343,CT Banana Half Wall Side,ZywOo,0,1,-1,0,100,-100,T,30
7344,CT Banana Sandbangs,ZywOo,0,0,0,0,5,-5,CT,30
7345,CT Banana Sandbangs,ZywOo,0,2,-2,0,124,-124,T,30
7346,Deep Apps Past Hallway,ZywOo,0,0,0,0,0,0,CT,30
7347,Deep Apps Past Hallway,ZywOo,0,0,0,0,0,0,T,30
7348,B Site,ZywOo,0,0,0,0,0,0,CT,30
7349,B Site,ZywOo,0,0,0,0,0,0,T,30
7350,A Site,ZywOo,3,1,2,375,153,222,CT,30
7351,A Site,ZywOo,0,0,0,0,0,0,T,30
7352,A Site Left Side Middle Boxes,ZywOo,0,1,-1,0,47,-47,CT,30
7353,A Site Left Side Middle Boxes,ZywOo,0,0,0,0,0,0,T,30
7354,Default Plant A Site,ZywOo,0,0,0,0,0,0,CT,30
7355,Default Plant A Site,ZywOo,0,0,0,0,0,0,T,30
7356,Pit,ZywOo,0,0,0,0,0,0,CT,30
7357,Pit,ZywOo,1,1,0,113,97,16,T,30
7358,Boiler Peek to Mid,ZywOo,0,1,-1,0,81,-81,CT,30
7359,Boiler Peek to Mid,ZywOo,0,0,0,0,0,0,T,30
7360,1st Oranges,ZywOo,0,0,0,0,0,0,CT,30
7361,1st Oranges,ZywOo,0,1,-1,0,100,-100,T,30
7362,Apartments,ZywOo,1,1,0,100,100,0,CT,30
7363,Apartments,ZywOo,0,0,0,0,0,0,T,30
7364,Chokepoint Entrance onto A site from Library Side,ZywOo,0,0,0,0,0,0,CT,30
7365,Chokepoint Entrance onto A site from Library Side,ZywOo,0,1,-1,0,100,-100,T,30
7366,Top Hay Bales,ZywOo,0,0,0,0,0,0,CT,30
7367,Top Hay Bales,ZywOo,0,1,-1,30,100,-70,T,30
7368,Lane Side,ZywOo,1,0,1,84,3,81,CT,30
7369,Lane Side,ZywOo,1,0,1,115,0,115,T,30
7370,Behind Coffins Playing the B Site Cross,ZywOo,0,1,-1,0,100,-100,CT,30
7371,Behind Coffins Playing the B Site Cross,ZywOo,0,0,0,0,0,0,T,30
7372,Bottom Mid exposed to Top Mid,ZywOo,0,0,0,0,6,-6,CT,30
7373,Bottom Mid exposed to Top Mid,ZywOo,0,0,0,37,47,-10,T,30
7374,Top Mid Lane Side ,ZywOo,1,0,1,100,0,100,CT,30
7375,Top Mid Lane Side ,ZywOo,1,0,1,100,56,44,T,30
7376,Deep CT Peeking Towards B Site,ZywOo,1,1,0,6,100,-94,CT,30
7377,Deep CT Peeking Towards B Site,ZywOo,0,0,0,0,0,0,T,30
7378,Graveyard Stairs,ZywOo,0,0,0,0,0,0,CT,30
7379,Graveyard Stairs,ZywOo,0,0,0,0,0,0,T,30
7380,Chokepoint Entering B,ZywOo,0,0,0,0,0,0,CT,30
7381,Chokepoint Entering B,ZywOo,2,0,2,184,71,113,T,30
7382,T Ramp Peeking Towards Mid,ZywOo,0,1,-1,30,100,-70,CT,30
7383,T Ramp Peeking Towards Mid,ZywOo,0,0,0,0,0,0,T,30
7384,Chokepoint Entering B,malbsMd,0,0,0,7,0,7,CT,21
7385,Chokepoint Entering B,malbsMd,0,0,0,0,0,0,T,21
7386,CT Peek Towards B Choke,malbsMd,1,1,0,120,167,-47,CT,21
7387,CT Peek Towards B Choke,malbsMd,0,1,-1,0,19,-19,T,21
7388,Lane Side,malbsMd,0,0,0,0,0,0,CT,21
7389,Lane Side,malbsMd,0,2,-2,0,211,-211,T,21
7390,B Site,malbsMd,0,0,0,0,0,0,CT,21
7391,B Site,malbsMd,1,0,1,100,0,100,T,21
7392,A Bombsite Back Site,malbsMd,0,0,0,0,0,0,CT,21
7393,A Bombsite Back Site,malbsMd,0,0,0,0,0,0,T,21
7394,CT Banana Half Wall Side,malbsMd,1,0,1,170,0,170,CT,21
7395,CT Banana Half Wall Side,malbsMd,4,0,4,400,96,304,T,21
7396,Behind Coffins Playing the B Site Cross,malbsMd,0,1,-1,63,33,30,CT,21
7397,Behind Coffins Playing the B Site Cross,malbsMd,1,0,1,100,0,100,T,21
7398,Logs,malbsMd,0,0,0,0,0,0,CT,21
7399,Logs,malbsMd,0,0,0,0,6,-6,T,21
7400,Boiler Side Stairs,malbsMd,0,1,-1,0,100,-100,CT,21
7401,Boiler Side Stairs,malbsMd,0,0,0,0,0,0,T,21
7402,A Site Behind Default Boxes,malbsMd,0,0,0,0,0,0,CT,21
7403,A Site Behind Default Boxes,malbsMd,0,0,0,0,0,0,T,21
7404,Banana,malbsMd,0,1,-1,87,100,-13,CT,21
7405,Banana,malbsMd,1,0,1,101,91,10,T,21
7406,CT Outside Arch,malbsMd,0,0,0,0,0,0,CT,21
7407,CT Outside Arch,malbsMd,0,1,-1,0,6,-6,T,21
7408,Pit Peek Towards Lane,malbsMd,0,0,0,0,0,0,CT,21
7409,Pit Peek Towards Lane,malbsMd,0,1,-1,0,23,-23,T,21
7410,Construction,malbsMd,0,0,0,0,0,0,CT,21
7411,Construction,malbsMd,1,0,1,100,0,100,T,21
7412,Default Plant A Site,malbsMd,0,0,0,0,0,0,CT,21
7413,Default Plant A Site,malbsMd,1,1,0,127,89,38,T,21
7414,Underpass,malbsMd,0,0,0,0,0,0,CT,21
7415,Underpass,malbsMd,0,0,0,0,0,0,T,21
7416,Apps T Side Stairs,malbsMd,0,0,0,19,0,19,CT,21
7417,Apps T Side Stairs,malbsMd,0,1,-1,0,100,-100,T,21
7418,Top Mid Chokepoint,malbsMd,2,1,1,209,100,109,CT,21
7419,Top Mid Chokepoint,malbsMd,0,0,0,0,0,0,T,21
7420,CT Arch,malbsMd,0,0,0,0,0,0,CT,21
7421,CT Arch,malbsMd,0,0,0,147,81,66,T,21
7422,CT Banana Close Left Half Wall,malbsMd,0,0,0,0,0,0,CT,21
7423,CT Banana Close Left Half Wall,malbsMd,0,1,-1,0,84,-84,T,21
7424,Front Coffins,malbsMd,0,0,0,0,0,0,CT,21
7425,Front Coffins,malbsMd,0,1,-1,0,12,-12,T,21
7426,CT Banana Sandbags Right Corner,malbsMd,0,0,0,0,0,0,CT,21
7427,CT Banana Sandbags Right Corner,malbsMd,0,1,-1,0,0,0,T,21
7428,1st Oranges,malbsMd,0,0,0,0,0,0,CT,21
7429,1st Oranges,malbsMd,0,1,-1,27,100,-73,T,21
7430,SecondMid,malbsMd,0,0,0,0,0,0,CT,21
7431,SecondMid,malbsMd,0,0,0,0,0,0,T,21
7432,Dark,malbsMd,0,1,-1,0,81,-81,CT,21
7433,Dark,malbsMd,0,0,0,0,0,0,T,21
7434,Deep CT Peeking Towards B Site,malbsMd,0,0,0,0,0,0,CT,21
7435,Deep CT Peeking Towards B Site,malbsMd,0,0,0,0,0,0,T,21
7436,2nd Oranges,malbsMd,0,0,0,0,0,0,CT,21
7437,2nd Oranges,malbsMd,0,0,0,0,0,0,T,21
7438,Arch Side,malbsMd,0,0,0,0,0,0,CT,21
7439,Arch Side,malbsMd,1,0,1,100,55,45,T,21
7440,CT Banana Sandbangs,malbsMd,0,0,0,0,0,0,CT,21
7441,CT Banana Sandbangs,malbsMd,0,0,0,0,0,0,T,21
7442,CT Banana Half Wall Side,Jackinho,1,4,-3,124,557,-433,CT,48
7443,CT Banana Half Wall Side,Jackinho,0,0,0,0,0,0,T,48
7444,Middle,Jackinho,0,2,-2,96,132,-36,CT,48
7445,Middle,Jackinho,0,1,-1,0,64,-64,T,48
7446,Banana,Jackinho,0,3,-3,0,263,-263,CT,48
7447,Banana,Jackinho,0,0,0,0,1,-1,T,48
7448,1st Oranges,Jackinho,1,2,-1,53,168,-115,CT,48
7449,1st Oranges,Jackinho,0,1,-1,0,49,-49,T,48
7450,A Bombsite Close Left,Jackinho,0,0,0,0,0,0,CT,48
7451,A Bombsite Close Left,Jackinho,0,1,-1,0,100,-100,T,48
7452,CT Peek Towards B Choke,Jackinho,0,2,-2,0,137,-137,CT,48
7453,CT Peek Towards B Choke,Jackinho,0,0,0,0,0,0,T,48
7454,Top Mid Lane Side ,Jackinho,0,0,0,0,0,0,CT,48
7455,Top Mid Lane Side ,Jackinho,0,1,-1,0,100,-100,T,48
7456,Behind Coffins Playing the B Site Cross,Jackinho,0,0,0,0,0,0,CT,48
7457,Behind Coffins Playing the B Site Cross,Jackinho,1,1,0,50,99,-49,T,48
7458,Boiler Peek to Mid,Jackinho,0,0,0,0,0,0,CT,48
7459,Boiler Peek to Mid,Jackinho,0,2,-2,84,221,-137,T,48
7460,A Site Behind Middle Boxes/Pillar hidden from Lane,Jackinho,1,1,0,100,35,65,CT,48
7461,A Site Behind Middle Boxes/Pillar hidden from Lane,Jackinho,0,0,0,0,0,0,T,48
7462,T Apps Bridge ,Jackinho,0,0,0,0,0,0,CT,48
7463,T Apps Bridge ,Jackinho,0,1,-1,86,100,-14,T,48
7464,Chokepoint Entering B,Jackinho,0,2,-2,8,284,-276,CT,48
7465,Chokepoint Entering B,Jackinho,0,0,0,0,0,0,T,48
7466,Top Mid Arch Side,Jackinho,0,0,0,0,0,0,CT,48
7467,Top Mid Arch Side,Jackinho,1,1,0,100,100,0,T,48
7468,Default Plant A Site,Jackinho,0,0,0,0,0,0,CT,48
7469,Default Plant A Site,Jackinho,0,1,-1,17,100,-83,T,48
7470,Grill,Jackinho,0,0,0,0,0,0,CT,48
7471,Grill,Jackinho,0,0,0,0,0,0,T,48
7472,TSpawn,Jackinho,0,1,-1,0,11,-11,CT,48
7473,TSpawn,Jackinho,0,0,0,0,0,0,T,48
7474,Left Side Quadbox Peek for a CT,Jackinho,0,1,-1,0,43,-43,CT,48
7475,Left Side Quadbox Peek for a CT,Jackinho,0,0,0,0,0,0,T,48
7476,A Site Left Side Middle Boxes,Jackinho,0,0,0,0,0,0,CT,48
7477,A Site Left Side Middle Boxes,Jackinho,0,0,0,0,0,0,T,48
7478,Fountain,Jackinho,0,1,-1,15,100,-85,CT,48
7479,Fountain,Jackinho,0,0,0,0,0,0,T,48
7480,Pit Peek Towards Lane,Jackinho,0,0,0,0,0,0,CT,48
7481,Pit Peek Towards Lane,Jackinho,0,0,0,0,0,0,T,48
7482,Balcony,Jackinho,0,0,0,0,0,0,CT,48
7483,Balcony,Jackinho,1,1,0,100,100,0,T,48
7484,Right Side Quadbox Peek for a CT,Jackinho,2,1,1,199,102,97,CT,48
7485,Right Side Quadbox Peek for a CT,Jackinho,0,0,0,0,0,0,T,48
7486,Top Hay Bales,Jackinho,0,0,0,0,0,0,CT,48
7487,Top Hay Bales,Jackinho,0,1,-1,0,100,-100,T,48
7488,Upstairs,Jackinho,0,0,0,0,0,0,CT,48
7489,Upstairs,Jackinho,0,0,0,0,0,0,T,48
7490,CT Banana Close Left Half Wall,Jackinho,1,1,0,137,143,-6,CT,48
7491,CT Banana Close Left Half Wall,Jackinho,0,0,0,0,0,0,T,48
7492,Apps T Side Stairs,Jackinho,0,0,0,0,0,0,CT,48
7493,Apps T Side Stairs,Jackinho,0,0,0,0,0,0,T,48
7494,Construction,Jackinho,0,0,0,0,0,0,CT,48
7495,Construction,Jackinho,0,0,0,0,0,0,T,48
7496,Arch Side Cubby,Jackinho,0,0,0,0,0,0,CT,48
7497,Arch Side Cubby,Jackinho,0,0,0,0,0,0,T,48
7498,SecondMid,Jackinho,0,0,0,0,0,0,CT,48
7499,SecondMid,Jackinho,1,1,0,87,136,-49,T,48
7500,Top Balcony ,Jackinho,0,0,0,0,0,0,CT,48
7501,Top Balcony ,Jackinho,3,1,2,352,155,197,T,48
7502,CT Boost,Jackinho,0,1,-1,0,100,-100,CT,48
7503,CT Boost,Jackinho,0,0,0,0,0,0,T,48
7504,2nd Oranges,Jackinho,1,1,0,77,100,-23,CT,48
7505,2nd Oranges,Jackinho,0,0,0,0,0,0,T,48
7506,Arch Side,Jackinho,0,0,0,0,8,-8,CT,48
7507,Arch Side,Jackinho,0,1,-1,0,69,-69,T,48
7508,CT Banana Barrels,Jackinho,0,0,0,0,0,0,CT,48
7509,CT Banana Barrels,Jackinho,0,0,0,0,0,0,T,48
7510,CT Banana Half Wall Side,maden,1,2,-1,139,123,16,CT,27
7511,CT Banana Half Wall Side,maden,1,0,1,14,21,-7,T,27
7512,Arch Side,maden,1,1,0,64,59,5,CT,27
7513,Arch Side,maden,0,1,-1,27,100,-73,T,27
7514,A Site,maden,0,0,0,0,0,0,CT,27
7515,A Site,maden,0,1,-1,0,55,-55,T,27
7516,CT Banana Barrels,maden,1,1,0,130,139,-9,CT,27
7517,CT Banana Barrels,maden,0,1,-1,0,100,-100,T,27
7518,Banana,maden,1,1,0,100,185,-85,CT,27
7519,Banana,maden,0,0,0,40,143,-103,T,27
7520,Top Mid Arch Side,maden,0,0,0,0,0,0,CT,27
7521,Top Mid Arch Side,maden,1,1,0,99,100,-1,T,27
7522,Construction,maden,0,1,-1,51,93,-42,CT,27
7523,Construction,maden,0,1,-1,69,78,-9,T,27
7524,B Site,maden,0,1,-1,0,100,-100,CT,27
7525,B Site,maden,1,1,0,26,100,-74,T,27
7526,Chokepoint Entering B,maden,1,1,0,101,114,-13,CT,27
7527,Chokepoint Entering B,maden,0,1,-1,0,75,-75,T,27
7528,CT Banana Sandbangs,maden,1,0,1,129,68,61,CT,27
7529,CT Banana Sandbangs,maden,0,1,-1,0,60,-60,T,27
7530,Library,maden,1,0,1,51,0,51,CT,27
7531,Library,maden,0,0,0,0,0,0,T,27
7532,Boiler Peek to Mid,maden,0,0,0,0,0,0,CT,27
7533,Boiler Peek to Mid,maden,0,1,-1,0,100,-100,T,27
7534,A Bombsite Close Left,maden,0,0,0,0,0,0,CT,27
7535,A Bombsite Close Left,maden,0,0,0,0,0,0,T,27
7536,Bottom Mid exposed to Top Mid,maden,0,1,-1,63,100,-37,CT,27
7537,Bottom Mid exposed to Top Mid,maden,0,0,0,0,0,0,T,27
7538,SecondMid,maden,0,0,0,0,0,0,CT,27
7539,SecondMid,maden,0,1,-1,10,100,-90,T,27
7540,CT Banana Sandbags Right Corner,maden,1,0,1,98,63,35,CT,27
7541,CT Banana Sandbags Right Corner,maden,0,0,0,0,0,0,T,27
7542,Deep Apps Past Hallway,maden,0,0,0,0,0,0,CT,27
7543,Deep Apps Past Hallway,maden,1,1,0,99,38,61,T,27
7544,Bottom Mid Banana,maden,0,1,-1,64,100,-36,CT,27
7545,Bottom Mid Banana,maden,0,0,0,7,1,6,T,27
7546,Boiler Side Stairs,maden,0,0,0,0,0,0,CT,27
7547,Boiler Side Stairs,maden,0,0,0,0,0,0,T,27
7548,Apps T Side Stairs,maden,0,0,0,0,0,0,CT,27
7549,Apps T Side Stairs,maden,0,0,0,0,0,0,T,27
7550,LowerMid,maden,0,0,0,0,0,0,CT,27
7551,LowerMid,maden,0,0,0,0,0,0,T,27
7552,CT Peek Towards B Choke,maden,1,1,0,100,109,-9,CT,27
7553,CT Peek Towards B Choke,maden,0,0,0,0,6,-6,T,27
7554,Outside Library,maden,0,0,0,0,0,0,CT,27
7555,Outside Library,maden,0,1,-1,72,73,-1,T,27
7556,T Ramp Peeking Towards Mid,maden,1,1,0,100,68,32,CT,27
7557,T Ramp Peeking Towards Mid,maden,0,0,0,0,0,0,T,27
7558,CT Banana Sandbangs,misutaaa,2,1,1,313,56,257,CT,30
7559,CT Banana Sandbangs,misutaaa,0,0,0,8,8,0,T,30
7560,Arch Side,misutaaa,0,1,-1,0,100,-100,CT,30
7561,Arch Side,misutaaa,0,1,-1,0,67,-67,T,30
7562,Chokepoint Entering B,misutaaa,0,0,0,76,22,54,CT,30
7563,Chokepoint Entering B,misutaaa,0,1,-1,0,100,-100,T,30
7564,Lane Side,misutaaa,2,1,1,99,100,-1,CT,30
7565,Lane Side,misutaaa,0,2,-2,37,200,-163,T,30
7566,Back Alley,misutaaa,0,0,0,0,0,0,CT,30
7567,Back Alley,misutaaa,0,2,-2,27,134,-107,T,30
7568,Banana,misutaaa,1,0,1,45,8,37,CT,30
7569,Banana,misutaaa,1,0,1,63,26,37,T,30
7570,CT Banana Half Wall Side,misutaaa,0,1,-1,64,149,-85,CT,30
7571,CT Banana Half Wall Side,misutaaa,1,0,1,89,42,47,T,30
7572,Top Mid Chokepoint,misutaaa,0,0,0,0,0,0,CT,30
7573,Top Mid Chokepoint,misutaaa,1,1,0,100,213,-113,T,30
7574,Library,misutaaa,0,0,0,0,0,0,CT,30
7575,Library,misutaaa,0,0,0,0,0,0,T,30
7576,PalaceInterior,misutaaa,0,0,0,0,0,0,CT,30
7577,PalaceInterior,misutaaa,0,1,-1,0,2,-2,T,30
7578,Lane Patio,misutaaa,0,0,0,0,0,0,CT,30
7579,Lane Patio,misutaaa,0,0,0,0,0,0,T,30
7580,Pit,misutaaa,0,0,0,0,0,0,CT,30
7581,Pit,misutaaa,0,0,0,0,0,0,T,30
7582,Quad Box,misutaaa,0,1,-1,0,100,-100,CT,30
7583,Quad Box,misutaaa,0,0,0,0,0,0,T,30
7584,1st Oranges,misutaaa,0,0,0,0,0,0,CT,30
7585,1st Oranges,misutaaa,0,0,0,0,0,0,T,30
7586,Deep Apps Past Hallway,misutaaa,0,0,0,0,0,0,CT,30
7587,Deep Apps Past Hallway,misutaaa,0,1,-1,0,100,-100,T,30
7588,Boiler Side Stairs,misutaaa,0,0,0,0,0,0,CT,30
7589,Boiler Side Stairs,misutaaa,0,0,0,0,0,0,T,30
7590,A Site Behind Middle Boxes/Pillar hidden from Lane,misutaaa,0,0,0,0,0,0,CT,30
7591,A Site Behind Middle Boxes/Pillar hidden from Lane,misutaaa,0,1,-1,24,96,-72,T,30
7592,Top Mid Lane Side ,misutaaa,0,0,0,0,0,0,CT,30
7593,Top Mid Lane Side ,misutaaa,0,0,0,0,0,0,T,30
7594,CT Banana Barrels,misutaaa,0,0,0,0,0,0,CT,30
7595,CT Banana Barrels,misutaaa,0,0,0,0,0,0,T,30
7596,A Bombsite Close Left,misutaaa,0,0,0,0,0,0,CT,30
7597,A Bombsite Close Left,misutaaa,0,0,0,0,0,0,T,30
7598,Chokepoint Entrance onto A site from Library Side,misutaaa,0,0,0,0,0,0,CT,30
7599,Chokepoint Entrance onto A site from Library Side,misutaaa,0,1,-1,0,100,-100,T,30
7600,Behind B Site Back Pillar,misutaaa,0,1,-1,0,47,-47,CT,30
7601,Behind B Site Back Pillar,misutaaa,0,0,0,0,0,0,T,30
7602,B Site,misutaaa,0,1,-1,0,13,-13,CT,30
7603,B Site,misutaaa,0,0,0,0,0,0,T,30
7604,Grill,misutaaa,0,0,0,0,0,0,CT,30
7605,Grill,misutaaa,0,1,-1,0,97,-97,T,30
7606,A Site,misutaaa,0,1,-1,0,99,-99,CT,30
7607,A Site,misutaaa,0,0,0,0,0,0,T,30
7608,Lane Side,RpK,0,0,0,6,0,6,CT,30
7609,Lane Side,RpK,0,0,0,0,0,0,T,30
7610,Grill,RpK,0,0,0,0,0,0,CT,30
7611,Grill,RpK,0,0,0,0,0,0,T,30
7612,1st Oranges,RpK,0,0,0,0,0,0,CT,30
7613,1st Oranges,RpK,0,0,0,0,0,0,T,30
7614,Bottom Mid Banana,RpK,0,1,-1,15,100,-85,CT,30
7615,Bottom Mid Banana,RpK,0,1,-1,0,108,-108,T,30
7616,B Site,RpK,1,1,0,122,100,22,CT,30
7617,B Site,RpK,2,1,1,199,138,61,T,30
7618,CT Peek Towards B Choke,RpK,0,1,-1,0,100,-100,CT,30
7619,CT Peek Towards B Choke,RpK,0,1,-1,0,130,-130,T,30
7620,Pit,RpK,0,1,-1,0,163,-163,CT,30
7621,Pit,RpK,0,1,-1,0,75,-75,T,30
7622,Top Mid Chokepoint,RpK,0,0,0,0,0,0,CT,30
7623,Top Mid Chokepoint,RpK,0,2,-2,0,194,-194,T,30
7624,CT Banana Half Wall Side,RpK,0,0,0,0,0,0,CT,30
7625,CT Banana Half Wall Side,RpK,0,1,-1,46,182,-136,T,30
7626,Pit Below Balcony,RpK,1,2,-1,127,200,-73,CT,30
7627,Pit Below Balcony,RpK,0,0,0,0,0,0,T,30
7628,A Site,RpK,0,1,-1,20,78,-58,CT,30
7629,A Site,RpK,0,0,0,0,0,0,T,30
7630,CT Banana Sandbangs,RpK,0,0,0,0,0,0,CT,30
7631,CT Banana Sandbangs,RpK,0,0,0,0,29,-29,T,30
7632,A Bombsite Close Left,RpK,0,0,0,0,0,0,CT,30
7633,A Bombsite Close Left,RpK,0,1,-1,0,92,-92,T,30
7634,Pit Peek Towards Lane,RpK,1,1,0,154,100,54,CT,30
7635,Pit Peek Towards Lane,RpK,0,0,0,0,0,0,T,30
7636,Back Alley,RpK,1,0,1,39,0,39,CT,30
7637,Back Alley,RpK,0,0,0,0,0,0,T,30
7638,Top Mid Lane Side ,RpK,0,0,0,0,0,0,CT,30
7639,Top Mid Lane Side ,RpK,0,1,-1,0,39,-39,T,30
7640,2nd Oranges,RpK,0,0,0,0,0,0,CT,30
7641,2nd Oranges,RpK,1,0,1,100,3,97,T,30
7642,Top Balcony ,RpK,1,1,0,123,100,23,CT,30
7643,Top Balcony ,RpK,0,0,0,0,24,-24,T,30
7644,Deep CT Peeking Towards B Site,RpK,0,1,-1,97,58,39,CT,30
7645,Deep CT Peeking Towards B Site,RpK,0,0,0,0,0,0,T,30
7646,Chokepoint Entrance onto A site from Library Side,RpK,0,0,0,0,0,0,CT,30
7647,Chokepoint Entrance onto A site from Library Side,RpK,0,0,0,0,0,0,T,30
7648,Chokepoint Entering B,RpK,1,0,1,136,54,82,CT,30
7649,Chokepoint Entering B,RpK,1,1,0,44,69,-25,T,30
7650,TSpawn,RpK,1,0,1,100,0,100,CT,30
7651,TSpawn,RpK,0,0,0,0,0,0,T,30
7652,B Site Cross for T's Exposed to CT and Quad,RpK,0,0,0,0,0,0,CT,30
7653,B Site Cross for T's Exposed to CT and Quad,RpK,0,1,-1,35,100,-65,T,30
7654,T Ramp Peeking Towards Mid,RpK,0,0,0,0,0,0,CT,30
7655,T Ramp Peeking Towards Mid,RpK,0,1,-1,0,100,-100,T,30
7656,Apps T Side Stairs,RpK,0,1,-1,0,100,-100,CT,30
7657,Apps T Side Stairs,RpK,0,0,0,0,0,0,T,30
7658,Behind Coffins Playing the B Site Cross,STYKO,0,1,-1,88,76,12,CT,27
7659,Behind Coffins Playing the B Site Cross,STYKO,0,0,0,0,0,0,T,27
7660,2nd Oranges,STYKO,0,0,0,0,0,0,CT,27
7661,2nd Oranges,STYKO,0,1,-1,30,100,-70,T,27
7662,Lane Side,STYKO,2,0,2,130,4,126,CT,27
7663,Lane Side,STYKO,0,0,0,0,0,0,T,27
7664,Top Balcony ,STYKO,0,0,0,0,0,0,CT,27
7665,Top Balcony ,STYKO,2,2,0,173,213,-40,T,27
7666,Apartments,STYKO,0,0,0,0,0,0,CT,27
7667,Apartments,STYKO,0,0,0,0,0,0,T,27
7668,Deep Apps Past Hallway,STYKO,0,0,0,0,0,0,CT,27
7669,Deep Apps Past Hallway,STYKO,1,2,-1,121,200,-79,T,27
7670,Pit,STYKO,0,1,-1,20,66,-46,CT,27
7671,Pit,STYKO,0,0,0,0,0,0,T,27
7672,Pit Below Balcony,STYKO,0,0,0,0,0,0,CT,27
7673,Pit Below Balcony,STYKO,0,0,0,0,0,0,T,27
7674,Fountain,STYKO,0,0,0,0,0,0,CT,27
7675,Fountain,STYKO,0,0,0,0,0,0,T,27
7676,Chokepoint Entering B,STYKO,0,0,0,0,0,0,CT,27
7677,Chokepoint Entering B,STYKO,2,1,1,178,19,159,T,27
7678,Apps T Side Stairs,STYKO,0,1,-1,0,100,-100,CT,27
7679,Apps T Side Stairs,STYKO,1,0,1,90,0,90,T,27
7680,Top Mid Lane Side ,STYKO,0,0,0,0,8,-8,CT,27
7681,Top Mid Lane Side ,STYKO,0,0,0,0,0,0,T,27
7682,1st Oranges,STYKO,0,0,0,0,0,0,CT,27
7683,1st Oranges,STYKO,1,1,0,127,100,27,T,27
7684,Default Plant A Site,STYKO,0,0,0,0,0,0,CT,27
7685,Default Plant A Site,STYKO,0,0,0,0,0,0,T,27
7686,Lane Behind Pillar,STYKO,0,1,-1,78,100,-22,CT,27
7687,Lane Behind Pillar,STYKO,0,0,0,0,0,0,T,27
7688,Construction,STYKO,1,1,0,57,73,-16,CT,27
7689,Construction,STYKO,0,0,0,0,0,0,T,27
7690,Apps Hallway,STYKO,0,0,0,0,0,0,CT,27
7691,Apps Hallway,STYKO,0,1,-1,84,100,-16,T,27
7692,Middle,STYKO,0,1,-1,54,100,-46,CT,27
7693,Middle,STYKO,0,0,0,0,0,0,T,27
7694,Boiler Peek to Mid,STYKO,0,0,0,0,6,-6,CT,27
7695,Boiler Peek to Mid,STYKO,0,0,0,0,0,0,T,27
7696,A Bombsite Close Left,STYKO,2,1,1,194,100,94,CT,27
7697,A Bombsite Close Left,STYKO,0,0,0,0,0,0,T,27
7698,Bottom Mid Banana,STYKO,0,1,-1,0,100,-100,CT,27
7699,Bottom Mid Banana,STYKO,0,0,0,0,0,0,T,27
7700,CT Outside Construction,STYKO,0,0,0,0,27,-27,CT,27
7701,CT Outside Construction,STYKO,0,0,0,0,0,0,T,27
7702,Pit Peek Towards Lane,STYKO,0,0,0,0,0,0,CT,27
7703,Pit Peek Towards Lane,STYKO,0,0,0,0,0,0,T,27
7704,A Site,STYKO,0,0,0,0,34,-34,CT,27
7705,A Site,STYKO,0,0,0,0,0,0,T,27
7706,Lane Side,apEX,1,1,0,40,28,12,CT,30
7707,Lane Side,apEX,1,1,0,100,130,-30,T,30
7708,Banana,apEX,0,1,-1,0,100,-100,CT,30
7709,Banana,apEX,0,2,-2,63,236,-173,T,30
7710,A Bombsite Close Left,apEX,0,1,-1,67,100,-33,CT,30
7711,A Bombsite Close Left,apEX,0,2,-2,0,170,-170,T,30
7712,CT Peek Towards B Choke,apEX,2,0,2,112,13,99,CT,30
7713,CT Peek Towards B Choke,apEX,0,2,-2,0,209,-209,T,30
7714,Boiler Side Stairs,apEX,0,1,-1,0,83,-83,CT,30
7715,Boiler Side Stairs,apEX,0,0,0,0,0,0,T,30
7716,Top Coffins,apEX,0,1,-1,76,79,-3,CT,30
7717,Top Coffins,apEX,0,0,0,0,0,0,T,30
7718,Deep CT Peeking Towards B Site,apEX,0,0,0,0,0,0,CT,30
7719,Deep CT Peeking Towards B Site,apEX,0,0,0,0,0,0,T,30
7720,Behind Coffins Playing the B Site Cross,apEX,0,1,-1,0,108,-108,CT,30
7721,Behind Coffins Playing the B Site Cross,apEX,0,1,-1,0,66,-66,T,30
7722,B Site,apEX,0,0,0,0,0,0,CT,30
7723,B Site,apEX,0,1,-1,0,53,-53,T,30
7724,CT Banana Sandbangs,apEX,0,0,0,0,0,0,CT,30
7725,CT Banana Sandbangs,apEX,0,0,0,0,43,-43,T,30
7726,Apps T Side Stairs,apEX,0,0,0,0,0,0,CT,30
7727,Apps T Side Stairs,apEX,1,0,1,100,47,53,T,30
7728,CT Arch,apEX,0,0,0,0,0,0,CT,30
7729,CT Arch,apEX,0,1,-1,0,99,-99,T,30
7730,CT Banana Half Wall Side,apEX,0,0,0,61,25,36,CT,30
7731,CT Banana Half Wall Side,apEX,0,1,-1,0,57,-57,T,30
7732,Construction,apEX,0,0,0,0,0,0,CT,30
7733,Construction,apEX,0,0,0,0,0,0,T,30
7734,CT Banana Barrels,apEX,0,0,0,0,8,-8,CT,30
7735,CT Banana Barrels,apEX,0,0,0,0,0,0,T,30
7736,Boiler Peek to Mid,apEX,0,0,0,0,0,0,CT,30
7737,Boiler Peek to Mid,apEX,0,0,0,0,0,0,T,30
7738,Top Mid Lane Side ,apEX,0,1,-1,0,44,-44,CT,30
7739,Top Mid Lane Side ,apEX,1,0,1,114,0,114,T,30
7740,Chokepoint Entrance onto A site from Library Side,apEX,0,0,0,0,0,0,CT,30
7741,Chokepoint Entrance onto A site from Library Side,apEX,0,0,0,0,0,0,T,30
7742,Chokepoint Entering B,apEX,0,0,0,16,0,16,CT,30
7743,Chokepoint Entering B,apEX,1,1,0,166,111,55,T,30
7744,2nd Oranges,apEX,1,1,0,97,100,-3,CT,30
7745,2nd Oranges,apEX,0,0,0,0,0,0,T,30
7746,B Site Cross for T's Exposed to CT and Quad,apEX,0,0,0,39,7,32,CT,30
7747,B Site Cross for T's Exposed to CT and Quad,apEX,0,0,0,0,0,0,T,30
7748,Upstairs,apEX,1,0,1,42,0,42,CT,30
7749,Upstairs,apEX,0,0,0,0,0,0,T,30
7750,A Bombsite Back Site,apEX,0,0,0,0,0,0,CT,30
7751,A Bombsite Back Site,apEX,0,1,-1,0,100,-100,T,30
7752,Outside Library,apEX,2,1,1,163,100,63,CT,30
7753,Outside Library,apEX,0,0,0,0,0,0,T,30
7754,A Site,apEX,0,1,-1,0,100,-100,CT,30
7755,A Site,apEX,0,0,0,0,0,0,T,30
7756,Arch Side,zehN,2,1,1,286,125,161,CT,27
7757,Arch Side,zehN,0,2,-2,11,199,-188,T,27
7758,Top Mid Lane Side ,zehN,0,0,0,0,0,0,CT,27
7759,Top Mid Lane Side ,zehN,0,1,-1,0,100,-100,T,27
7760,Grill,zehN,0,0,0,0,0,0,CT,27
7761,Grill,zehN,0,1,-1,0,13,-13,T,27
7762,CT Boost,zehN,0,2,-2,85,183,-98,CT,27
7763,CT Boost,zehN,0,0,0,0,0,0,T,27
7764,Deep CT Peeking Towards B Site,zehN,0,0,0,0,0,0,CT,27
7765,Deep CT Peeking Towards B Site,zehN,0,0,0,0,0,0,T,27
7766,2nd Oranges,zehN,2,1,1,200,47,153,CT,27
7767,2nd Oranges,zehN,0,1,-1,0,82,-82,T,27
7768,Construction,zehN,0,0,0,0,0,0,CT,27
7769,Construction,zehN,0,0,0,0,0,0,T,27
7770,Boiler Room,zehN,0,0,0,0,0,0,CT,27
7771,Boiler Room,zehN,0,0,0,0,0,0,T,27
7772,Banana,zehN,0,0,0,0,0,0,CT,27
7773,Banana,zehN,0,0,0,151,39,112,T,27
7774,Pit,zehN,0,1,-1,76,108,-32,CT,27
7775,Pit,zehN,0,0,0,0,0,0,T,27
7776,Lane Peek Towards Top Mid,zehN,0,1,-1,5,10,-5,CT,27
7777,Lane Peek Towards Top Mid,zehN,0,0,0,0,0,0,T,27
7778,CT Arch,zehN,0,0,0,0,0,0,CT,27
7779,CT Arch,zehN,0,0,0,0,0,0,T,27
7780,Top Mid Arch Side,zehN,0,0,0,44,0,44,CT,27
7781,Top Mid Arch Side,zehN,0,1,-1,0,100,-100,T,27
7782,TopofMid,zehN,0,1,-1,0,100,-100,CT,27
7783,TopofMid,zehN,0,0,0,0,0,0,T,27
7784,Library,zehN,0,0,0,77,32,45,CT,27
7785,Library,zehN,0,0,0,0,0,0,T,27
7786,Front Coffins,zehN,0,0,0,0,0,0,CT,27
7787,Front Coffins,zehN,0,1,-1,31,87,-56,T,27
7788,Lane Behind Pillar,zehN,0,0,0,0,3,-3,CT,27
7789,Lane Behind Pillar,zehN,0,0,0,0,0,0,T,27
7790,CT Peek Towards B Choke,zehN,0,0,0,0,0,0,CT,27
7791,CT Peek Towards B Choke,zehN,0,0,0,0,35,-35,T,27
7792,Chokepoint Entering B,zehN,0,0,0,81,85,-4,CT,27
7793,Chokepoint Entering B,zehN,0,1,-1,28,72,-44,T,27
7794,Lane Patio,zehN,0,0,0,0,0,0,CT,27
7795,Lane Patio,zehN,0,0,0,0,0,0,T,27
7796,T Ramp Peeking Towards Mid,zehN,0,1,-1,0,100,-100,CT,27
7797,T Ramp Peeking Towards Mid,zehN,0,0,0,0,0,0,T,27
7798,CT Peek Towards B Choke,farlig,1,1,0,100,46,54,CT,27
7799,CT Peek Towards B Choke,farlig,0,0,0,0,8,-8,T,27
7800,Top Mid Arch Side,farlig,0,1,-1,0,100,-100,CT,27
7801,Top Mid Arch Side,farlig,0,2,-2,0,200,-200,T,27
7802,Chokepoint Entering B,farlig,0,1,-1,73,251,-178,CT,27
7803,Chokepoint Entering B,farlig,2,0,2,166,117,49,T,27
7804,CT Banana Sandbangs,farlig,0,0,0,0,0,0,CT,27
7805,CT Banana Sandbangs,farlig,0,0,0,0,0,0,T,27
7806,Lane Side,farlig,0,1,-1,0,100,-100,CT,27
7807,Lane Side,farlig,0,1,-1,0,100,-100,T,27
7808,B Site,farlig,0,0,0,0,69,-69,CT,27
7809,B Site,farlig,1,0,1,100,0,100,T,27
7810,2nd Oranges,farlig,0,0,0,0,0,0,CT,27
7811,2nd Oranges,farlig,0,1,-1,0,69,-69,T,27
7812,CT Arch,farlig,0,1,-1,0,6,-6,CT,27
7813,CT Arch,farlig,0,0,0,0,0,0,T,27
7814,Deep CT Peeking Towards B Site,farlig,1,1,0,100,100,0,CT,27
7815,Deep CT Peeking Towards B Site,farlig,0,0,0,0,0,0,T,27
7816,Library,farlig,0,1,-1,0,100,-100,CT,27
7817,Library,farlig,0,0,0,0,0,0,T,27
7818,Logs,farlig,0,0,0,0,0,0,CT,27
7819,Logs,farlig,0,1,-1,57,100,-43,T,27
7820,Apps T Side Stairs,farlig,0,0,0,0,0,0,CT,27
7821,Apps T Side Stairs,farlig,0,0,0,0,0,0,T,27
7822,Grill,farlig,0,0,0,0,0,0,CT,27
7823,Grill,farlig,0,1,-1,9,58,-49,T,27
7824,Behind Coffins Playing the B Site Cross,farlig,1,1,0,136,100,36,CT,27
7825,Behind Coffins Playing the B Site Cross,farlig,0,0,0,0,24,-24,T,27
7826,CT Banana Half Wall Side,farlig,0,0,0,0,0,0,CT,27
7827,CT Banana Half Wall Side,farlig,2,0,2,200,2,198,T,27
7828,Top Mid Chokepoint,farlig,0,0,0,0,0,0,CT,27
7829,Top Mid Chokepoint,farlig,0,0,0,0,0,0,T,27
7830,Front Coffins,farlig,0,0,0,0,0,0,CT,27
7831,Front Coffins,farlig,0,1,-1,0,76,-76,T,27
7832,Boiler Peek to Mid,farlig,0,1,-1,0,73,-73,CT,27
7833,Boiler Peek to Mid,farlig,0,0,0,0,0,0,T,27
7834,1st Oranges,farlig,0,1,-1,0,17,-17,CT,27
7835,1st Oranges,farlig,0,0,0,0,0,0,T,27
7836,Dark,farlig,1,1,0,100,31,69,CT,27
7837,Dark,farlig,0,0,0,0,0,0,T,27
7838,Pit,farlig,0,0,0,0,0,0,CT,27
7839,Pit,farlig,0,1,-1,27,98,-71,T,27
7840,Banana,Maluk3,1,0,1,23,27,-4,CT,21
7841,Banana,Maluk3,0,2,-2,0,200,-200,T,21
7842,Top Mid Lane Side ,Maluk3,0,0,0,0,0,0,CT,21
7843,Top Mid Lane Side ,Maluk3,1,2,-1,148,192,-44,T,21
7844,Middle,Maluk3,1,0,1,17,0,17,CT,21
7845,Middle,Maluk3,1,1,0,100,102,-2,T,21
7846,Back Alley,Maluk3,0,0,0,0,0,0,CT,21
7847,Back Alley,Maluk3,0,0,0,0,0,0,T,21
7848,Apps T Side Stairs,Maluk3,0,0,0,0,0,0,CT,21
7849,Apps T Side Stairs,Maluk3,0,1,-1,0,100,-100,T,21
7850,Quad Box,Maluk3,0,0,0,0,0,0,CT,21
7851,Quad Box,Maluk3,0,1,-1,0,100,-100,T,21
7852,Top Mid Chokepoint,Maluk3,0,1,-1,0,100,-100,CT,21
7853,Top Mid Chokepoint,Maluk3,0,0,0,0,0,0,T,21
7854,Right Side Quadbox Peek for a CT,Maluk3,0,0,0,0,0,0,CT,21
7855,Right Side Quadbox Peek for a CT,Maluk3,0,0,0,0,0,0,T,21
7856,CT Banana Half Wall Side,Maluk3,0,0,0,0,0,0,CT,21
7857,CT Banana Half Wall Side,Maluk3,0,1,-1,0,102,-102,T,21
7858,Grill,Maluk3,0,0,0,0,0,0,CT,21
7859,Grill,Maluk3,0,0,0,0,0,0,T,21
7860,1st Oranges,Maluk3,0,0,0,0,0,0,CT,21
7861,1st Oranges,Maluk3,0,0,0,0,0,0,T,21
7862,Deep Apps Past Hallway,Maluk3,0,0,0,0,0,0,CT,21
7863,Deep Apps Past Hallway,Maluk3,0,1,-1,0,56,-56,T,21
7864,Top Balcony ,Maluk3,0,0,0,0,0,0,CT,21
7865,Top Balcony ,Maluk3,0,1,-1,19,73,-54,T,21
7866,Lane Side,Maluk3,0,0,0,0,0,0,CT,21
7867,Lane Side,Maluk3,1,0,1,100,0,100,T,21
7868,B Site,Maluk3,0,1,-1,0,99,-99,CT,21
7869,B Site,Maluk3,0,0,0,0,0,0,T,21
7870,CT Peek Towards B Choke,Maluk3,2,1,1,118,154,-36,CT,21
7871,CT Peek Towards B Choke,Maluk3,0,0,0,0,0,0,T,21
7872,Top Mid Arch Side,Maluk3,0,0,0,0,0,0,CT,21
7873,Top Mid Arch Side,Maluk3,0,0,0,0,0,0,T,21
7874,Top Hay Bales,Maluk3,0,1,-1,81,73,8,CT,21
7875,Top Hay Bales,Maluk3,0,0,0,0,0,0,T,21
7876,B Site Cross for T's Exposed to CT and Quad,Maluk3,0,0,0,0,0,0,CT,21
7877,B Site Cross for T's Exposed to CT and Quad,Maluk3,0,0,0,0,0,0,T,21
7878,Boiler Side Stairs,Maluk3,0,0,0,0,0,0,CT,21
7879,Boiler Side Stairs,Maluk3,0,1,-1,0,100,-100,T,21
7880,Logs,Maluk3,0,0,0,0,0,0,CT,21
7881,Logs,Maluk3,0,0,0,0,0,0,T,21
7882,Arch Side,Maluk3,0,0,0,0,0,0,CT,21
7883,Arch Side,Maluk3,0,1,-1,0,100,-100,T,21
7884,Boiler Room,Maluk3,0,1,-1,26,100,-74,CT,21
7885,Boiler Room,Maluk3,0,0,0,0,0,0,T,21
7886,T Ramp Peeking Towards Mid,prt,0,0,0,0,0,0,CT,21
7887,T Ramp Peeking Towards Mid,prt,0,1,-1,0,104,-104,T,21
7888,Chokepoint Entering B,prt,0,1,-1,22,100,-78,CT,21
7889,Chokepoint Entering B,prt,0,1,-1,0,146,-146,T,21
7890,Lane Side,prt,0,1,-1,0,100,-100,CT,21
7891,Lane Side,prt,1,1,0,63,100,-37,T,21
7892,CT Banana Half Wall Side,prt,0,0,0,0,0,0,CT,21
7893,CT Banana Half Wall Side,prt,0,1,-1,0,36,-36,T,21
7894,Top Balcony ,prt,0,0,0,6,0,6,CT,21
7895,Top Balcony ,prt,0,2,-2,0,156,-156,T,21
7896,Behind Coffins Playing the B Site Cross,prt,0,0,0,0,0,0,CT,21
7897,Behind Coffins Playing the B Site Cross,prt,0,0,0,0,0,0,T,21
7898,Underpass,prt,0,0,0,0,0,0,CT,21
7899,Underpass,prt,0,0,0,0,0,0,T,21
7900,A Site,prt,0,0,0,0,0,0,CT,21
7901,A Site,prt,0,1,-1,0,76,-76,T,21
7902,Boiler Room,prt,0,1,-1,0,28,-28,CT,21
7903,Boiler Room,prt,0,0,0,0,0,0,T,21
7904,CT Outside Arch,prt,0,0,0,0,0,0,CT,21
7905,CT Outside Arch,prt,1,0,1,8,0,8,T,21
7906,B Site Cross for T's Exposed to CT and Quad,prt,0,0,0,0,0,0,CT,21
7907,B Site Cross for T's Exposed to CT and Quad,prt,0,0,0,0,0,0,T,21
7908,Top Mid Lane Side ,prt,1,0,1,91,72,19,CT,21
7909,Top Mid Lane Side ,prt,0,1,-1,0,96,-96,T,21
7910,SecondMid,prt,1,0,1,100,0,100,CT,21
7911,SecondMid,prt,0,0,0,0,0,0,T,21
7912,1st Oranges,prt,0,0,0,0,0,0,CT,21
7913,1st Oranges,prt,0,1,-1,48,74,-26,T,21
7914,Pit Below Balcony,prt,0,0,0,0,0,0,CT,21
7915,Pit Below Balcony,prt,0,0,0,0,0,0,T,21
7916,Middle,prt,1,1,0,100,100,0,CT,21
7917,Middle,prt,0,0,0,0,0,0,T,21
7918,Top Hay Bales,prt,0,1,-1,0,100,-100,CT,21
7919,Top Hay Bales,prt,0,0,0,0,0,0,T,21
7920,B Site,prt,0,0,0,0,0,0,CT,21
7921,B Site,prt,1,1,0,100,65,35,T,21
7922,Apartments Hallway Peek from T Side,prt,0,0,0,0,0,0,CT,21
7923,Apartments Hallway Peek from T Side,prt,0,0,0,0,0,0,T,21
7924,Grill,prt,0,0,0,0,0,0,CT,21
7925,Grill,prt,0,1,-1,0,103,-103,T,21
7926,Chokepoint Entering B,suNny,0,1,-1,107,154,-47,CT,27
7927,Chokepoint Entering B,suNny,0,2,-2,14,168,-154,T,27
7928,CT Banana Half Wall Side,suNny,0,1,-1,0,100,-100,CT,27
7929,CT Banana Half Wall Side,suNny,1,3,-2,171,262,-91,T,27
7930,Banana,suNny,0,2,-2,77,200,-123,CT,27
7931,Banana,suNny,0,1,-1,18,155,-137,T,27
7932,Arch Side,suNny,0,0,0,0,0,0,CT,27
7933,Arch Side,suNny,1,2,-1,121,196,-75,T,27
7934,Deep Apps Past Hallway,suNny,0,0,0,0,0,0,CT,27
7935,Deep Apps Past Hallway,suNny,0,0,0,0,0,0,T,27
7936,CT Outside Arch,suNny,0,1,-1,0,100,-100,CT,27
7937,CT Outside Arch,suNny,0,0,0,0,0,0,T,27
7938,Underpass,suNny,0,0,0,0,0,0,CT,27
7939,Underpass,suNny,0,0,0,0,0,0,T,27
7940,Middle,suNny,1,1,0,127,100,27,CT,27
7941,Middle,suNny,0,0,0,0,0,0,T,27
7942,SecondMid,suNny,0,0,0,0,0,0,CT,27
7943,SecondMid,suNny,0,1,-1,0,115,-115,T,27
7944,Top Mid Lane Side ,suNny,0,1,-1,49,100,-51,CT,27
7945,Top Mid Lane Side ,suNny,0,0,0,0,0,0,T,27
7946,Pit,suNny,0,0,0,0,0,0,CT,27
7947,Pit,suNny,0,0,0,0,0,0,T,27
7948,Top Coffins,suNny,1,1,0,100,100,0,CT,27
7949,Top Coffins,suNny,0,0,0,0,0,0,T,27
7950,Top Balcony ,suNny,0,0,0,0,0,0,CT,27
7951,Top Balcony ,suNny,0,1,-1,0,100,-100,T,27
7952,Lane Side,suNny,0,0,0,0,0,0,CT,27
7953,Lane Side,suNny,0,0,0,36,0,36,T,27
7954,CT Peek Towards B Choke,suNny,1,1,0,101,73,28,CT,27
7955,CT Peek Towards B Choke,suNny,0,0,0,0,0,0,T,27
7956,2nd Oranges,suNny,0,1,-1,22,100,-78,CT,27
7957,2nd Oranges,suNny,0,0,0,0,0,0,T,27
7958,CT Banana Sandbangs,suNny,0,1,-1,0,79,-79,CT,27
7959,CT Banana Sandbangs,suNny,0,0,0,0,0,0,T,27
7960,A Site,Skullz,0,0,0,0,0,0,CT,21
7961,A Site,Skullz,0,2,-2,0,111,-111,T,21
7962,Middle,Skullz,1,2,-1,159,200,-41,CT,21
7963,Middle,Skullz,0,0,0,0,0,0,T,21
7964,Lane Side,Skullz,0,0,0,0,0,0,CT,21
7965,Lane Side,Skullz,1,1,0,100,190,-90,T,21
7966,Top Graveyard,Skullz,0,0,0,0,0,0,CT,21
7967,Top Graveyard,Skullz,0,1,-1,0,89,-89,T,21
7968,CT Peek Towards B Choke,Skullz,1,1,0,103,100,3,CT,21
7969,CT Peek Towards B Choke,Skullz,0,0,0,0,0,0,T,21
7970,Bottom Mid exposed to Top Mid,Skullz,0,1,-1,0,100,-100,CT,21
7971,Bottom Mid exposed to Top Mid,Skullz,0,0,0,0,0,0,T,21
7972,CT Arch,Skullz,0,0,0,0,0,0,CT,21
7973,CT Arch,Skullz,0,1,-1,0,100,-100,T,21
7974,Top Mid Chokepoint,Skullz,0,0,0,0,0,0,CT,21
7975,Top Mid Chokepoint,Skullz,0,1,-1,0,100,-100,T,21
7976,Grill,Skullz,0,0,0,0,0,0,CT,21
7977,Grill,Skullz,0,1,-1,0,64,-64,T,21
7978,A Site Behind Middle Boxes/Pillar hidden from Lane,Skullz,0,0,0,0,0,0,CT,21
7979,A Site Behind Middle Boxes/Pillar hidden from Lane,Skullz,2,0,2,200,17,183,T,21
7980,Lane Patio,Skullz,0,1,-1,109,100,9,CT,21
7981,Lane Patio,Skullz,0,0,0,0,0,0,T,21
7982,Banana,Skullz,0,0,0,0,0,0,CT,21
7983,Banana,Skullz,0,1,-1,27,100,-73,T,21
7984,Top Balcony ,Skullz,0,0,0,0,0,0,CT,21
7985,Top Balcony ,Skullz,1,0,1,100,0,100,T,21
7986,A Site Right Side Middle Pillar,Skullz,0,0,0,0,0,0,CT,21
7987,A Site Right Side Middle Pillar,Skullz,0,1,-1,0,71,-71,T,21
7988,Chokepoint Entrance onto A site from Library Side,Skullz,0,0,0,0,0,0,CT,21
7989,Chokepoint Entrance onto A site from Library Side,Skullz,0,0,0,0,0,0,T,21
7990,Chokepoint Entering B,Skullz,0,0,0,0,0,0,CT,21
7991,Chokepoint Entering B,Skullz,0,1,-1,27,101,-74,T,21
7992,B Site,Skullz,0,0,0,0,0,0,CT,21
7993,B Site,Skullz,0,0,0,0,0,0,T,21
7994,A Bombsite Back Site,Skullz,0,0,0,0,0,0,CT,21
7995,A Bombsite Back Site,Skullz,0,1,-1,27,60,-33,T,21
7996,Arch Side,Skullz,0,0,0,0,0,0,CT,21
7997,Arch Side,Skullz,0,0,0,0,0,0,T,21
7998,Top Mid Lane Side ,Skullz,0,0,0,0,0,0,CT,21
7999,Top Mid Lane Side ,Skullz,0,1,-1,0,100,-100,T,21
8000,Back Alley,pesadelo,0,1,-1,24,24,0,CT,21
8001,Back Alley,pesadelo,1,0,1,12,0,12,T,21
8002,Middle,pesadelo,0,2,-2,32,200,-168,CT,21
8003,Middle,pesadelo,0,0,0,0,0,0,T,21
8004,CT Banana Half Wall Side,pesadelo,0,0,0,0,0,0,CT,21
8005,CT Banana Half Wall Side,pesadelo,1,2,-1,100,232,-132,T,21
8006,CT Banana Sandbangs,pesadelo,0,1,-1,0,101,-101,CT,21
8007,CT Banana Sandbangs,pesadelo,0,0,0,85,0,85,T,21
8008,Default Plant A Site,pesadelo,0,0,0,0,0,0,CT,21
8009,Default Plant A Site,pesadelo,1,2,-1,207,193,14,T,21
8010,Boiler Side Stairs,pesadelo,0,0,0,19,0,19,CT,21
8011,Boiler Side Stairs,pesadelo,0,1,-1,54,92,-38,T,21
8012,B Site Cross for T's Exposed to CT and Quad,pesadelo,0,1,-1,33,100,-67,CT,21
8013,B Site Cross for T's Exposed to CT and Quad,pesadelo,1,0,1,100,0,100,T,21
8014,Behind B Site Back Pillar,pesadelo,0,0,0,0,0,0,CT,21
8015,Behind B Site Back Pillar,pesadelo,0,1,-1,0,37,-37,T,21
8016,CT Outside Kitchen,pesadelo,0,0,0,0,0,0,CT,21
8017,CT Outside Kitchen,pesadelo,0,0,0,0,0,0,T,21
8018,Banana,pesadelo,0,1,-1,0,99,-99,CT,21
8019,Banana,pesadelo,0,0,0,0,8,-8,T,21
8020,Deep CT Peeking Towards B Site,pesadelo,0,0,0,0,0,0,CT,21
8021,Deep CT Peeking Towards B Site,pesadelo,0,1,-1,0,58,-58,T,21
8022,SecondMid,pesadelo,0,0,0,0,0,0,CT,21
8023,SecondMid,pesadelo,0,1,-1,88,100,-12,T,21
8024,Grill,pesadelo,0,0,0,0,0,0,CT,21
8025,Grill,pesadelo,0,1,-1,27,141,-114,T,21
8026,Top Mid Arch Side,pesadelo,0,0,0,0,0,0,CT,21
8027,Top Mid Arch Side,pesadelo,0,1,-1,0,84,-84,T,21
8028,Quad Box,pesadelo,0,0,0,0,0,0,CT,21
8029,Quad Box,pesadelo,0,1,-1,0,68,-68,T,21
8030,A Bombsite Close Left,pesadelo,0,0,0,0,0,0,CT,21
8031,A Bombsite Close Left,pesadelo,0,0,0,0,6,-6,T,21
8032,CT Peek Towards B Choke,pesadelo,0,0,0,0,0,0,CT,21
8033,CT Peek Towards B Choke,pesadelo,0,0,0,0,0,0,T,21
