,Location,Player,Kills,Deaths,K/D,Damage Dealt,Damage Taken,Damage Differential,Side,Total Rounds
0,CT Side Apps,Stavn,4,7,-3,476,669,-193,CT,358
1,CT Side Apps,Stavn,9,4,5,965,721,244,T,358
2,Top Balcony,Stavn,1,4,-3,106,327,-221,CT,358
3,Top Balcony,Stavn,2,6,-4,211,624,-413,T,358
4,Ticketbooth ,Stavn,16,5,11,1659,628,1031,CT,358
5,Ticketbooth ,Stavn,1,0,1,67,0,67,T,358
6,A Site,Stavn,0,0,0,18,20,-2,CT,358
7,A Site,Stavn,4,8,-4,594,677,-83,T,358
8,A Site Exposed to Stairs Connector Cat,Stavn,6,3,3,705,306,399,CT,358
9,A Site Exposed to Stairs Connector Cat,Stavn,0,3,-3,16,135,-119,T,358
10,Bottom Stairs,Stavn,6,4,2,724,427,297,CT,358
11,Bottom Stairs,Stavn,3,4,-1,202,400,-198,T,358
12,A Ramp,Stavn,2,0,2,238,22,216,CT,358
13,A Ramp,Stavn,8,6,2,1033,650,383,T,358
14,Triple Box,Stavn,2,3,-1,193,226,-33,CT,358
15,Triple Box,Stavn,1,2,-1,36,234,-198,T,358
16,Deep T Apps,Stavn,2,1,1,192,57,135,CT,358
17,Deep T Apps,Stavn,4,4,0,607,600,7,T,358
18,Deep Jungle,Stavn,10,5,5,1413,520,893,CT,358
19,Deep Jungle,Stavn,4,4,0,443,296,147,T,358
20,Deep Catwalk,Stavn,3,3,0,440,316,124,CT,358
21,Deep Catwalk,Stavn,2,3,-1,201,170,31,T,358
22,CT Catwalk,Stavn,5,4,1,577,532,45,CT,358
23,CT Catwalk,Stavn,5,0,5,476,48,428,T,358
24,Mid Close Connector,Stavn,2,2,0,129,190,-61,CT,358
25,Mid Close Connector,Stavn,1,3,-2,100,343,-243,T,358
26,Top Connector,Stavn,0,4,-4,130,400,-270,CT,358
27,Top Connector,Stavn,0,2,-2,44,200,-156,T,358
28,Deep Palace,Stavn,1,3,-2,122,219,-97,CT,358
29,Deep Palace,Stavn,0,0,0,29,54,-25,T,358
30,Bench,Stavn,3,3,0,316,300,16,CT,358
31,Bench,Stavn,1,2,-1,165,147,18,T,358
32,Default A,Stavn,5,5,0,605,586,19,CT,358
33,Default A,Stavn,3,1,2,356,190,166,T,358
34,Back Left B Site From T's' Perspective,Stavn,4,4,0,427,503,-76,CT,358
35,Back Left B Site From T's' Perspective,Stavn,0,0,0,0,0,0,T,358
36,Underneath B apps plat,Stavn,1,1,0,124,100,24,CT,358
37,Underneath B apps plat,Stavn,3,3,0,246,245,1,T,358
38,Snipers Palace Peek,Stavn,3,2,1,301,386,-85,CT,358
39,Snipers Palace Peek,Stavn,1,1,0,127,201,-74,T,358
40,Left Side Platform,Stavn,2,2,0,155,154,1,CT,358
41,Left Side Platform,Stavn,3,4,-1,336,602,-266,T,358
42,Snipers Nest,Stavn,6,3,3,481,356,125,CT,358
43,Snipers Nest,Stavn,2,1,1,200,60,140,T,358
44,Close A Ramp,Stavn,1,1,0,105,100,5,CT,358
45,Close A Ramp,Stavn,2,4,-2,344,453,-109,T,358
46,CT Deep Catwalk Mid peek,Stavn,6,2,4,661,220,441,CT,358
47,CT Deep Catwalk Mid peek,Stavn,4,3,1,323,349,-26,T,358
48,Top Mid Left Side,Stavn,0,0,0,0,0,0,CT,358
49,Top Mid Left Side,Stavn,1,2,-1,133,134,-1,T,358
50,Top Mid,Stavn,1,2,-1,155,200,-45,CT,358
51,Top Mid,Stavn,0,2,-2,93,240,-147,T,358
52,Close Left CT A Ramp,Stavn,1,0,1,41,0,41,CT,358
53,Close Left CT A Ramp,Stavn,0,1,-1,82,178,-96,T,358
54,Deep T Apps Underpass STairs,Stavn,2,1,1,258,127,131,CT,358
55,Deep T Apps Underpass STairs,Stavn,0,1,-1,6,121,-115,T,358
56,Catwalk Connector Peek,Stavn,2,0,2,173,0,173,CT,358
57,Catwalk Connector Peek,Stavn,1,2,-1,69,185,-116,T,358
58,Tetris,Stavn,1,0,1,42,59,-17,CT,358
59,Tetris,Stavn,3,3,0,490,381,109,T,358
60,market,Stavn,3,1,2,287,150,137,CT,358
61,market,Stavn,1,2,-1,121,164,-43,T,358
62,Underpass,Stavn,1,1,0,110,197,-87,CT,358
63,Underpass,Stavn,1,2,-1,235,202,33,T,358
64,T Palace Stairs Peek,Stavn,5,0,5,500,0,500,CT,358
65,T Palace Stairs Peek,Stavn,4,2,2,400,221,179,T,358
66,Arch,Stavn,0,2,-2,28,162,-134,CT,358
67,Arch,Stavn,0,1,-1,22,36,-14,T,358
68,T Deep Apps Underpass/Apps Peek,Stavn,0,0,0,0,0,0,CT,358
69,T Deep Apps Underpass/Apps Peek,Stavn,2,2,0,258,211,47,T,358
70,B site Market Plant,Stavn,0,1,-1,137,46,91,CT,358
71,B site Market Plant,Stavn,0,0,0,0,0,0,T,358
72,B Bombsite Cross to Catwalk,Stavn,0,0,0,0,0,0,CT,358
73,B Bombsite Cross to Catwalk,Stavn,2,3,-1,288,276,12,T,358
74,Bottom Connector,Stavn,3,1,2,254,131,123,CT,358
75,Bottom Connector,Stavn,0,1,-1,91,139,-48,T,358
76,B Site Default Plant,Stavn,0,2,-2,43,254,-211,CT,358
77,B Site Default Plant,Stavn,1,2,-1,112,128,-16,T,358
78,Close Right Market Window,Stavn,0,1,-1,0,90,-90,CT,358
79,Close Right Market Window,Stavn,2,2,0,219,127,92,T,358
80,Sandwhich,Stavn,0,1,-1,0,21,-21,CT,358
81,Sandwhich,Stavn,4,0,4,324,44,280,T,358
82,Catwalk T Aparments Peek,Stavn,1,1,0,100,200,-100,CT,358
83,Catwalk T Aparments Peek,Stavn,0,2,-2,0,122,-122,T,358
84,Right Side Connector,Stavn,2,3,-1,200,388,-188,CT,358
85,Right Side Connector,Stavn,0,0,0,0,0,0,T,358
86,CT Outside Market,Stavn,2,1,1,200,100,100,CT,358
87,CT Outside Market,Stavn,1,0,1,100,0,100,T,358
88,Right Side Platform,Stavn,0,0,0,0,0,0,CT,358
89,Right Side Platform,Stavn,1,1,0,118,100,18,T,358
90,Leftside Connector,Stavn,6,2,4,538,357,181,CT,358
91,Leftside Connector,Stavn,0,0,0,0,0,0,T,358
92,Catwalk Plant B Site,Stavn,1,0,1,92,0,92,CT,358
93,Catwalk Plant B Site,Stavn,3,0,3,197,0,197,T,358
94,Under balcony,Stavn,1,0,1,92,6,86,CT,358
95,Under balcony,Stavn,0,1,-1,0,72,-72,T,358
96,Stairs Palace Peek,Stavn,0,1,-1,0,100,-100,CT,358
97,Stairs Palace Peek,Stavn,0,0,0,0,35,-35,T,358
98,Close Market door,Stavn,1,0,1,18,0,18,CT,358
99,Close Market door,Stavn,0,0,0,0,0,0,T,358
100,Firebox,Stavn,0,0,0,0,0,0,CT,358
101,Firebox,Stavn,1,1,0,127,50,77,T,358
102,Inside Market Doors,Stavn,1,2,-1,81,152,-71,CT,358
103,Inside Market Doors,Stavn,1,0,1,100,0,100,T,358
104,Middle Bench,Stavn,1,0,1,131,0,131,CT,358
105,Middle Bench,Stavn,0,1,-1,65,0,65,T,358
106,Back B Site Peeking Apps/Plat,Stavn,1,0,1,125,0,125,CT,358
107,Back B Site Peeking Apps/Plat,Stavn,1,1,0,188,100,88,T,358
108,Deep CT,Stavn,5,1,4,479,107,372,CT,358
109,Deep CT,Stavn,1,0,1,100,12,88,T,358
110,Back Right B Site from T's Perspective,Stavn,2,2,0,108,200,-92,CT,358
111,Back Right B Site from T's Perspective,Stavn,0,0,0,0,0,0,T,358
112,Top Van,Stavn,0,1,-1,0,100,-100,CT,358
113,Top Van,Stavn,0,1,-1,0,100,-100,T,358
114,Top Mid Catwalk,Stavn,0,0,0,0,0,0,CT,358
115,Top Mid Catwalk,Stavn,0,1,-1,118,100,18,T,358
116,Market Window Peek,Stavn,3,2,1,233,280,-47,CT,358
117,Market Window Peek,Stavn,1,0,1,100,0,100,T,358
118,CT Left Side,Stavn,1,2,-1,118,294,-176,CT,358
119,CT Left Side,Stavn,0,0,0,0,0,0,T,358
120,Ladder Room Catwalk Side,Stavn,1,1,0,100,100,0,CT,358
121,Ladder Room Catwalk Side,Stavn,0,0,0,0,0,0,T,358
122,CT Spawn,Stavn,0,1,-1,0,100,-100,CT,358
123,CT Spawn,Stavn,0,1,-1,26,100,-74,T,358
124,Right Side Snipers Nest,Stavn,0,1,-1,46,100,-54,CT,358
125,Right Side Snipers Nest,Stavn,1,0,1,100,0,100,T,358
126,Jungle Plant,Stavn,1,1,0,61,100,-39,CT,358
127,Jungle Plant,Stavn,0,0,0,0,0,0,T,358
128,Apartments Right CT Corner,Stavn,1,0,1,100,0,100,CT,358
129,Apartments Right CT Corner,Stavn,0,1,-1,19,102,-83,T,358
130,Semi Elevated CT Van,Stavn,0,0,0,0,0,0,CT,358
131,Semi Elevated CT Van,Stavn,0,0,0,0,0,0,T,358
132,T Spawn towards Apps,Stavn,0,0,0,0,0,0,CT,358
133,T Spawn towards Apps,Stavn,0,0,0,0,0,0,T,358
134,Balcony Boaxes,Stavn,0,0,0,58,0,58,CT,358
135,Balcony Boaxes,Stavn,0,0,0,0,0,0,T,358
136,Left Side corner deep jungle,Stavn,6,0,6,516,79,437,CT,358
137,Left Side corner deep jungle,Stavn,1,0,1,100,0,100,T,358
138,Bench Closer To Jungle,Stavn,0,0,0,0,0,0,CT,358
139,Bench Closer To Jungle,Stavn,0,0,0,0,0,0,T,358
140,Flowerpot CT,Stavn,0,0,0,0,0,0,CT,358
141,Flowerpot CT,Stavn,1,0,1,5,0,5,T,358
142,Underpass Peek from Snipers,Stavn,0,0,0,3,0,3,CT,358
143,Underpass Peek from Snipers,Stavn,1,1,0,100,120,-20,T,358
144,Top Mid Right Side,Stavn,0,0,0,0,0,0,CT,358
145,Top Mid Right Side,Stavn,1,0,1,68,0,68,T,358
146,T Spawn,Stavn,1,0,1,100,0,100,CT,358
147,T Spawn,Stavn,0,0,0,0,0,0,T,358
148,Safe Plant B Site,Stavn,0,0,0,40,0,40,CT,358
149,Safe Plant B Site,Stavn,0,0,0,0,0,0,T,358
150,EastForest,Stavn,0,0,0,0,0,0,CT,358
151,EastForest,Stavn,0,1,-1,0,100,-100,T,358
152,Ninja,Stavn,0,0,0,0,0,0,CT,358
153,Ninja,Stavn,0,0,0,0,0,0,T,358
154,Bottom Mid Ladder Room Peek,Stavn,1,0,1,100,0,100,CT,358
155,Bottom Mid Ladder Room Peek,Stavn,0,0,0,0,0,0,T,358
156,Register Market,Stavn,0,0,0,0,0,0,CT,358
157,Register Market,Stavn,0,0,0,0,0,0,T,358
158,Top Mid Boxes Left Side Peek,Stavn,1,0,1,100,0,100,CT,358
159,Top Mid Boxes Left Side Peek,Stavn,0,1,-1,45,100,-55,T,358
160,Bench Closer to Tribox,Stavn,0,0,0,0,0,0,CT,358
161,Bench Closer to Tribox,Stavn,0,0,0,0,0,0,T,358
162,BackCourtyard,Stavn,0,1,-1,0,100,-100,CT,358
163,BackCourtyard,Stavn,0,0,0,0,0,0,T,358
164,Top STairs,Stavn,1,0,1,6,0,6,CT,358
165,Top STairs,Stavn,3,0,3,300,86,214,T,358
166,T Deep apps,Stavn,0,1,-1,0,100,-100,CT,358
167,T Deep apps,Stavn,0,0,0,0,0,0,T,358
168,Under window B apps,Stavn,0,1,-1,0,100,-100,CT,358
169,Under window B apps,Stavn,0,0,0,9,0,9,T,358
170,CT Side Apps,Teses,1,1,0,100,214,-114,CT,358
171,CT Side Apps,Teses,3,3,0,362,556,-194,T,358
172,Mid Close Connector,Teses,1,1,0,190,199,-9,CT,358
173,Mid Close Connector,Teses,3,9,-6,463,852,-389,T,358
174,Bottom Stairs,Teses,6,4,2,413,296,117,CT,358
175,Bottom Stairs,Teses,1,4,-3,187,334,-147,T,358
176,Ticketbooth ,Teses,11,7,4,894,1006,-112,CT,358
177,Ticketbooth ,Teses,5,1,4,251,19,232,T,358
178,B Bombsite Cross to Catwalk,Teses,1,1,0,30,100,-70,CT,358
179,B Bombsite Cross to Catwalk,Teses,3,5,-2,447,643,-196,T,358
180,Left Side Platform,Teses,3,2,1,576,317,259,CT,358
181,Left Side Platform,Teses,2,6,-4,200,316,-116,T,358
182,Default A,Teses,2,4,-2,331,425,-94,CT,358
183,Default A,Teses,2,3,-1,88,281,-193,T,358
184,Deep Catwalk,Teses,7,4,3,672,427,245,CT,358
185,Deep Catwalk,Teses,5,2,3,511,363,148,T,358
186,A Site Exposed to Stairs Connector Cat,Teses,4,4,0,366,335,31,CT,358
187,A Site Exposed to Stairs Connector Cat,Teses,3,3,0,415,319,96,T,358
188,A Ramp,Teses,3,2,1,431,317,114,CT,358
189,A Ramp,Teses,3,2,1,214,273,-59,T,358
190,CT Catwalk,Teses,7,2,5,854,304,550,CT,358
191,CT Catwalk,Teses,3,5,-2,226,491,-265,T,358
192,Top Balcony,Teses,4,3,1,246,205,41,CT,358
193,Top Balcony,Teses,0,2,-2,101,339,-238,T,358
194,CT Deep Catwalk Mid peek,Teses,3,4,-1,272,472,-200,CT,358
195,CT Deep Catwalk Mid peek,Teses,2,2,0,226,226,0,T,358
196,Bottom Connector,Teses,0,2,-2,0,102,-102,CT,358
197,Bottom Connector,Teses,2,2,0,192,200,-8,T,358
198,A Site,Teses,4,2,2,217,157,60,CT,358
199,A Site,Teses,2,6,-4,122,681,-559,T,358
200,Close A Ramp,Teses,3,1,2,386,133,253,CT,358
201,Close A Ramp,Teses,1,6,-5,118,443,-325,T,358
202,Jungle Plant,Teses,1,2,-1,114,127,-13,CT,358
203,Jungle Plant,Teses,0,2,-2,0,66,-66,T,358
204,Bench,Teses,5,5,0,618,511,107,CT,358
205,Bench,Teses,0,1,-1,0,67,-67,T,358
206,Top Mid Left Side,Teses,0,1,-1,60,37,23,CT,358
207,Top Mid Left Side,Teses,5,5,0,640,811,-171,T,358
208,Triple Box,Teses,2,1,1,102,174,-72,CT,358
209,Triple Box,Teses,1,2,-1,101,164,-63,T,358
210,Catwalk Connector Peek,Teses,1,1,0,100,171,-71,CT,358
211,Catwalk Connector Peek,Teses,3,4,-1,335,472,-137,T,358
212,Deep Jungle,Teses,1,1,0,93,108,-15,CT,358
213,Deep Jungle,Teses,4,3,1,339,294,45,T,358
214,Top Mid,Teses,4,2,2,365,289,76,CT,358
215,Top Mid,Teses,2,0,2,226,23,203,T,358
216,Snipers Nest,Teses,1,1,0,182,229,-47,CT,358
217,Snipers Nest,Teses,0,1,-1,84,100,-16,T,358
218,Back B Site Peeking Apps/Plat,Teses,4,3,1,316,336,-20,CT,358
219,Back B Site Peeking Apps/Plat,Teses,2,1,1,200,99,101,T,358
220,Deep T Apps,Teses,2,3,-1,200,300,-100,CT,358
221,Deep T Apps,Teses,4,1,3,441,181,260,T,358
222,Arch,Teses,6,2,4,461,175,286,CT,358
223,Arch,Teses,1,1,0,92,79,13,T,358
224,CT Left Side,Teses,1,4,-3,30,292,-262,CT,358
225,CT Left Side,Teses,2,0,2,148,22,126,T,358
226,Deep CT,Teses,4,1,3,262,303,-41,CT,358
227,Deep CT,Teses,3,1,2,274,62,212,T,358
228,T Palace Stairs Peek,Teses,0,0,0,0,27,-27,CT,358
229,T Palace Stairs Peek,Teses,1,1,0,161,101,60,T,358
230,Ladder Room Catwalk Side,Teses,4,2,2,501,143,358,CT,358
231,Ladder Room Catwalk Side,Teses,2,0,2,192,20,172,T,358
232,T Spawn A Ramp,Teses,1,2,-1,191,197,-6,CT,358
233,T Spawn A Ramp,Teses,0,0,0,126,63,63,T,358
234,T Deep Apps Underpass/Apps Peek,Teses,1,0,1,130,73,57,CT,358
235,T Deep Apps Underpass/Apps Peek,Teses,0,2,-2,35,224,-189,T,358
236,market,Teses,0,1,-1,0,19,-19,CT,358
237,market,Teses,1,0,1,17,13,4,T,358
238,Catwalk T Aparments Peek,Teses,0,2,-2,75,156,-81,CT,358
239,Catwalk T Aparments Peek,Teses,3,2,1,377,108,269,T,358
240,Right Side Connector,Teses,3,1,2,120,100,20,CT,358
241,Right Side Connector,Teses,0,2,-2,0,200,-200,T,358
242,Underneath B apps plat,Teses,3,4,-1,497,407,90,CT,358
243,Underneath B apps plat,Teses,0,0,0,0,22,-22,T,358
244,Back Left B Site From T's' Perspective,Teses,5,4,1,658,447,211,CT,358
245,Back Left B Site From T's' Perspective,Teses,0,0,0,66,0,66,T,358
246,Deep T Spawn T Ramp,Teses,1,3,-2,235,213,22,CT,358
247,Deep T Spawn T Ramp,Teses,0,0,0,0,0,0,T,358
248,Close Market door,Teses,1,2,-1,127,200,-73,CT,358
249,Close Market door,Teses,1,1,0,90,87,3,T,358
250,Catwalk Plant B Site,Teses,0,1,-1,0,0,0,CT,358
251,Catwalk Plant B Site,Teses,0,2,-2,60,88,-28,T,358
252,Close Left CT A Ramp,Teses,0,1,-1,0,100,-100,CT,358
253,Close Left CT A Ramp,Teses,2,2,0,175,251,-76,T,358
254,Close Right Market Window,Teses,0,1,-1,58,100,-42,CT,358
255,Close Right Market Window,Teses,2,2,0,171,97,74,T,358
256,Top Mid towards Apps,Teses,0,1,-1,37,74,-37,CT,358
257,Top Mid towards Apps,Teses,1,0,1,145,1,144,T,358
258,Semi Elevated CT Van,Teses,5,3,2,482,245,237,CT,358
259,Semi Elevated CT Van,Teses,0,0,0,0,0,0,T,358
260,Apartments Right CT Corner,Teses,0,0,0,0,0,0,CT,358
261,Apartments Right CT Corner,Teses,1,1,0,73,100,-27,T,358
262,B site Market Plant,Teses,3,1,2,293,221,72,CT,358
263,B site Market Plant,Teses,1,0,1,100,0,100,T,358
264,T Deep apps,Teses,1,2,-1,100,127,-27,CT,358
265,T Deep apps,Teses,0,0,0,0,0,0,T,358
266,Ninja,Teses,1,3,-2,246,300,-54,CT,358
267,Ninja,Teses,0,0,0,65,28,37,T,358
268,Murder Hole,Teses,0,1,-1,31,100,-69,CT,358
269,Murder Hole,Teses,0,0,0,0,0,0,T,358
270,Right Side Platform,Teses,3,1,2,232,112,120,CT,358
271,Right Side Platform,Teses,0,0,0,0,0,0,T,358
272,Top Connector,Teses,0,0,0,5,0,5,CT,358
273,Top Connector,Teses,3,0,3,354,66,288,T,358
274,Firebox,Teses,0,0,0,0,0,0,CT,358
275,Firebox,Teses,1,0,1,22,19,3,T,358
276,Leftside Connector,Teses,1,0,1,100,0,100,CT,358
277,Leftside Connector,Teses,0,2,-2,103,210,-107,T,358
278,CT Spawn,Teses,0,1,-1,0,100,-100,CT,358
279,CT Spawn,Teses,0,0,0,0,0,0,T,358
280,Bottom Mid Boosting Snipers,Teses,0,0,0,0,0,0,CT,358
281,Bottom Mid Boosting Snipers,Teses,0,1,-1,39,0,39,T,358
282,T Spawn,Teses,1,0,1,100,0,100,CT,358
283,T Spawn,Teses,0,0,0,0,0,0,T,358
284,Snipers Palace Peek,Teses,1,0,1,24,20,4,CT,358
285,Snipers Palace Peek,Teses,0,1,-1,0,3,-3,T,358
286,Left Side corner deep jungle,Teses,0,1,-1,0,100,-100,CT,358
287,Left Side corner deep jungle,Teses,0,0,0,0,0,0,T,358
288,Top Mid Boxes Left Side Peek,Teses,0,0,0,68,0,68,CT,358
289,Top Mid Boxes Left Side Peek,Teses,1,1,0,52,94,-42,T,358
290,Sandwhich,Teses,0,0,0,0,0,0,CT,358
291,Sandwhich,Teses,0,0,0,14,0,14,T,358
292,Van Barrel Peek,Teses,0,1,-1,0,79,-79,CT,358
293,Van Barrel Peek,Teses,0,0,0,0,0,0,T,358
294,Stairs Palace Peek,Teses,0,0,0,88,38,50,CT,358
295,Stairs Palace Peek,Teses,0,0,0,0,100,-100,T,358
296,CT Outside Market,Teses,2,1,1,109,100,9,CT,358
297,CT Outside Market,Teses,0,0,0,0,0,0,T,358
298,Back Right B Site from T's Perspective,Teses,1,0,1,164,0,164,CT,358
299,Back Right B Site from T's Perspective,Teses,0,1,-1,0,87,-87,T,358
300,Tetris,Teses,2,1,1,175,67,108,CT,358
301,Tetris,Teses,1,0,1,93,95,-2,T,358
302,Under balcony,Teses,0,1,-1,44,222,-178,CT,358
303,Under balcony,Teses,0,0,0,0,12,-12,T,358
304,Inside Market Doors,Teses,0,1,-1,140,152,-12,CT,358
305,Inside Market Doors,Teses,1,0,1,100,0,100,T,358
306,Deep Palace,Teses,0,1,-1,44,73,-29,CT,358
307,Deep Palace,Teses,1,0,1,90,32,58,T,358
308,Connector behind box,Teses,0,1,-1,41,99,-58,CT,358
309,Connector behind box,Teses,2,0,2,205,88,117,T,358
310,Forest,Teses,0,0,0,44,7,37,CT,358
311,Forest,Teses,0,0,0,0,0,0,T,358
312,B Site Default Plant,Teses,0,0,0,20,0,20,CT,358
313,B Site Default Plant,Teses,0,0,0,0,0,0,T,358
314,Deep T Apps Underpass STairs,Teses,0,0,0,0,0,0,CT,358
315,Deep T Apps Underpass STairs,Teses,0,0,0,0,0,0,T,358
316,Middle Bench,Teses,1,0,1,30,0,30,CT,358
317,Middle Bench,Teses,0,1,-1,0,40,-40,T,358
318,Balcony Boaxes,Teses,0,1,-1,28,100,-72,CT,358
319,Balcony Boaxes,Teses,0,0,0,0,0,0,T,358
320,Top Mid Boxes Right Side Peek,Teses,0,0,0,0,0,0,CT,358
321,Top Mid Boxes Right Side Peek,Teses,0,0,0,0,45,-45,T,358
322,Underpass,Teses,1,0,1,100,0,100,CT,358
323,Underpass,Teses,2,0,2,162,176,-14,T,358
324,Top Van,Teses,0,0,0,29,21,8,CT,358
325,Top Van,Teses,0,0,0,0,0,0,T,358
326,Behind Big Boxes,Teses,0,0,0,0,0,0,CT,358
327,Behind Big Boxes,Teses,2,0,2,113,45,68,T,358
328,Top STairs,Teses,2,0,2,115,0,115,CT,358
329,Top STairs,Teses,0,0,0,0,0,0,T,358
330,Top Mid Catwalk,Teses,0,0,0,0,0,0,CT,358
331,Top Mid Catwalk,Teses,2,0,2,196,18,178,T,358
332,Bench Closer to Tribox,Teses,1,0,1,18,34,-16,CT,358
333,Bench Closer to Tribox,Teses,0,1,-1,78,55,23,T,358
334,Bottom Mid Ladder Room Peek,Teses,0,0,0,0,0,0,CT,358
335,Bottom Mid Ladder Room Peek,Teses,0,1,-1,0,100,-100,T,358
336,Flowerpot CT,Teses,0,0,0,0,0,0,CT,358
337,Flowerpot CT,Teses,0,0,0,0,0,0,T,358
338,Barn,Teses,0,1,-1,0,91,-91,CT,358
339,Barn,Teses,0,0,0,0,0,0,T,358
340,T Spawn towards Apps,Teses,1,0,1,100,0,100,CT,358
341,T Spawn towards Apps,Teses,1,0,1,252,13,239,T,358
342,Stairs Smoke Platform,Teses,0,0,0,0,0,0,CT,358
343,Stairs Smoke Platform,Teses,0,0,0,0,0,0,T,358
344,Right Side Snipers Nest,Teses,1,0,1,74,7,67,CT,358
345,Right Side Snipers Nest,Teses,0,0,0,0,0,0,T,358
346,Top Mid on top of Boxes,Teses,0,0,0,0,0,0,CT,358
347,Top Mid on top of Boxes,Teses,0,1,-1,25,87,-62,T,358
348,T Apps TV,Teses,0,0,0,0,0,0,CT,358
349,T Apps TV,Teses,0,0,0,0,0,0,T,358
350,Under window B apps,Teses,0,0,0,0,0,0,CT,358
351,Under window B apps,Teses,0,0,0,0,54,-54,T,358
352,Safe Plant B Site,Teses,0,0,0,8,0,8,CT,358
353,Safe Plant B Site,Teses,0,0,0,0,0,0,T,358
354,BackCourtyard,Teses,0,0,0,0,0,0,CT,358
355,BackCourtyard,Teses,0,1,-1,0,100,-100,T,358
356,Ticketbooth ,Cadian,15,9,6,1571,1514,57,CT,358
357,Ticketbooth ,Cadian,0,1,-1,83,99,-16,T,358
358,CT Side Apps,Cadian,5,0,5,533,43,490,CT,358
359,CT Side Apps,Cadian,4,6,-2,539,617,-78,T,358
360,CT Deep Catwalk Mid peek,Cadian,4,4,0,654,489,165,CT,358
361,CT Deep Catwalk Mid peek,Cadian,2,4,-2,274,348,-74,T,358
362,A Ramp,Cadian,0,3,-3,183,300,-117,CT,358
363,A Ramp,Cadian,8,7,1,745,804,-59,T,358
364,CT Catwalk,Cadian,5,1,4,708,234,474,CT,358
365,CT Catwalk,Cadian,2,6,-4,396,439,-43,T,358
366,Bottom Stairs,Cadian,8,2,6,738,231,507,CT,358
367,Bottom Stairs,Cadian,2,3,-1,185,357,-172,T,358
368,Triple Box,Cadian,5,5,0,482,348,134,CT,358
369,Triple Box,Cadian,0,3,-3,0,151,-151,T,358
370,Default A,Cadian,2,4,-2,129,400,-271,CT,358
371,Default A,Cadian,2,3,-1,171,173,-2,T,358
372,Mid Close Connector,Cadian,1,3,-2,127,356,-229,CT,358
373,Mid Close Connector,Cadian,0,4,-4,0,368,-368,T,358
374,Top Mid Left Side,Cadian,0,0,0,0,0,0,CT,358
375,Top Mid Left Side,Cadian,2,4,-2,373,630,-257,T,358
376,Bottom Connector,Cadian,2,2,0,179,162,17,CT,358
377,Bottom Connector,Cadian,1,1,0,100,167,-67,T,358
378,Underpass,Cadian,6,3,3,588,393,195,CT,358
379,Underpass,Cadian,2,4,-2,219,405,-186,T,358
380,market,Cadian,5,2,3,434,268,166,CT,358
381,market,Cadian,1,3,-2,100,254,-154,T,358
382,B Bombsite Cross to Catwalk,Cadian,0,2,-2,0,173,-173,CT,358
383,B Bombsite Cross to Catwalk,Cadian,3,3,0,227,300,-73,T,358
384,T Deep Apps Underpass/Apps Peek,Cadian,0,1,-1,14,76,-62,CT,358
385,T Deep Apps Underpass/Apps Peek,Cadian,2,3,-1,200,279,-79,T,358
386,Catwalk Connector Peek,Cadian,2,1,1,91,100,-9,CT,358
387,Catwalk Connector Peek,Cadian,1,4,-3,248,372,-124,T,358
388,Deep Catwalk,Cadian,2,2,0,157,131,26,CT,358
389,Deep Catwalk,Cadian,2,1,1,188,156,32,T,358
390,Deep T Apps,Cadian,0,1,-1,0,100,-100,CT,358
391,Deep T Apps,Cadian,0,2,-2,20,372,-352,T,358
392,Close Market door,Cadian,5,3,2,258,300,-42,CT,358
393,Close Market door,Cadian,0,1,-1,0,100,-100,T,358
394,A Site Exposed to Stairs Connector Cat,Cadian,1,2,-1,175,226,-51,CT,358
395,A Site Exposed to Stairs Connector Cat,Cadian,2,0,2,138,87,51,T,358
396,A Site,Cadian,0,1,-1,0,100,-100,CT,358
397,A Site,Cadian,2,2,0,236,251,-15,T,358
398,Murder Hole,Cadian,2,1,1,219,116,103,CT,358
399,Murder Hole,Cadian,0,2,-2,0,192,-192,T,358
400,Back Left B Site From T's' Perspective,Cadian,2,3,-1,31,184,-153,CT,358
401,Back Left B Site From T's' Perspective,Cadian,1,0,1,100,0,100,T,358
402,Deep Jungle,Cadian,6,4,2,682,400,282,CT,358
403,Deep Jungle,Cadian,1,2,-1,180,229,-49,T,358
404,CT Left Side,Cadian,1,4,-3,59,402,-343,CT,358
405,CT Left Side,Cadian,0,0,0,0,0,0,T,358
406,Bench,Cadian,4,2,2,422,244,178,CT,358
407,Bench,Cadian,1,0,1,100,0,100,T,358
408,T Palace Stairs Peek,Cadian,2,1,1,200,178,22,CT,358
409,T Palace Stairs Peek,Cadian,0,1,-1,0,108,-108,T,358
410,Top Mid Catwalk,Cadian,0,0,0,0,0,0,CT,358
411,Top Mid Catwalk,Cadian,1,3,-2,99,300,-201,T,358
412,Close A Ramp,Cadian,0,1,-1,24,89,-65,CT,358
413,Close A Ramp,Cadian,0,3,-3,13,387,-374,T,358
414,Underneath B apps plat,Cadian,4,2,2,349,200,149,CT,358
415,Underneath B apps plat,Cadian,0,1,-1,0,113,-113,T,358
416,Leftside Connector,Cadian,1,1,0,164,110,54,CT,358
417,Leftside Connector,Cadian,2,3,-1,245,272,-27,T,358
418,Top Mid,Cadian,1,2,-1,100,200,-100,CT,358
419,Top Mid,Cadian,2,2,0,137,236,-99,T,358
420,Snipers Nest,Cadian,6,2,4,766,522,244,CT,358
421,Snipers Nest,Cadian,1,1,0,100,100,0,T,358
422,Top STairs,Cadian,3,2,1,314,227,87,CT,358
423,Top STairs,Cadian,1,0,1,100,0,100,T,358
424,Top Balcony,Cadian,1,0,1,100,0,100,CT,358
425,Top Balcony,Cadian,4,0,4,296,14,282,T,358
426,Deep Palace,Cadian,1,0,1,15,0,15,CT,358
427,Deep Palace,Cadian,0,0,0,0,0,0,T,358
428,Market Window Peek,Cadian,4,3,1,609,286,323,CT,358
429,Market Window Peek,Cadian,0,1,-1,0,100,-100,T,358
430,Arch,Cadian,0,1,-1,0,78,-78,CT,358
431,Arch,Cadian,2,2,0,221,211,10,T,358
432,T Spawn A Ramp,Cadian,1,1,0,33,127,-94,CT,358
433,T Spawn A Ramp,Cadian,1,1,0,100,114,-14,T,358
434,Deep T Apps Underpass STairs,Cadian,2,1,1,285,124,161,CT,358
435,Deep T Apps Underpass STairs,Cadian,0,0,0,1,1,0,T,358
436,Close Left CT A Ramp,Cadian,1,0,1,78,0,78,CT,358
437,Close Left CT A Ramp,Cadian,0,0,0,0,0,0,T,358
438,Stairs Palace Peek,Cadian,0,2,-2,13,219,-206,CT,358
439,Stairs Palace Peek,Cadian,1,0,1,139,0,139,T,358
440,Left Side Platform,Cadian,1,2,-1,164,233,-69,CT,358
441,Left Side Platform,Cadian,2,1,1,35,215,-180,T,358
442,Deep CT,Cadian,9,3,6,743,271,472,CT,358
443,Deep CT,Cadian,0,0,0,0,0,0,T,358
444,Catwalk T Aparments Peek,Cadian,4,1,3,236,83,153,CT,358
445,Catwalk T Aparments Peek,Cadian,4,0,4,339,168,171,T,358
446,B Site Default Plant,Cadian,1,2,-1,64,200,-136,CT,358
447,B Site Default Plant,Cadian,2,0,2,276,33,243,T,358
448,Back Right B Site from T's Perspective,Cadian,0,1,-1,0,100,-100,CT,358
449,Back Right B Site from T's Perspective,Cadian,0,0,0,0,0,0,T,358
450,Jungle Plant,Cadian,0,0,0,28,0,28,CT,358
451,Jungle Plant,Cadian,2,1,1,213,170,43,T,358
452,Right Side Platform,Cadian,2,2,0,134,200,-66,CT,358
453,Right Side Platform,Cadian,0,0,0,0,0,0,T,358
454,Snipers Palace Peek,Cadian,3,2,1,330,157,173,CT,358
455,Snipers Palace Peek,Cadian,2,0,2,120,0,120,T,358
456,Back B Site Peeking Apps/Plat,Cadian,1,1,0,100,100,0,CT,358
457,Back B Site Peeking Apps/Plat,Cadian,2,0,2,117,23,94,T,358
458,Catwalk Plant B Site,Cadian,0,0,0,0,0,0,CT,358
459,Catwalk Plant B Site,Cadian,1,1,0,100,174,-74,T,358
460,Tetris,Cadian,0,0,0,50,11,39,CT,358
461,Tetris,Cadian,1,0,1,87,43,44,T,358
462,CT Outside Market,Cadian,1,1,0,139,82,57,CT,358
463,CT Outside Market,Cadian,0,0,0,0,0,0,T,358
464,Ninja,Cadian,3,0,3,216,0,216,CT,358
465,Ninja,Cadian,1,0,1,100,1,99,T,358
466,Middle Bench,Cadian,0,0,0,0,0,0,CT,358
467,Middle Bench,Cadian,1,1,0,100,162,-62,T,358
468,B site Market Plant,Cadian,0,2,-2,71,200,-129,CT,358
469,B site Market Plant,Cadian,2,0,2,174,0,174,T,358
470,Van Barrel Peek,Cadian,0,0,0,0,0,0,CT,358
471,Van Barrel Peek,Cadian,1,1,0,1,98,-97,T,358
472,Firebox,Cadian,0,0,0,0,0,0,CT,358
473,Firebox,Cadian,0,1,-1,44,100,-56,T,358
474,Ladder Room Catwalk Side,Cadian,1,0,1,73,0,73,CT,358
475,Ladder Room Catwalk Side,Cadian,0,1,-1,4,104,-100,T,358
476,Top Mid Boxes Right Side Peek,Cadian,0,0,0,0,0,0,CT,358
477,Top Mid Boxes Right Side Peek,Cadian,0,2,-2,66,200,-134,T,358
478,Top Connector,Cadian,2,1,1,216,145,71,CT,358
479,Top Connector,Cadian,1,1,0,100,100,0,T,358
480,Bottom Mid Ladder Room Peek,Cadian,0,0,0,0,0,0,CT,358
481,Bottom Mid Ladder Room Peek,Cadian,0,0,0,0,0,0,T,358
482,Top Mid Right Side,Cadian,0,0,0,0,0,0,CT,358
483,Top Mid Right Side,Cadian,0,1,-1,0,100,-100,T,358
484,Top Mid Boxes Left Side Peek,Cadian,0,0,0,0,0,0,CT,358
485,Top Mid Boxes Left Side Peek,Cadian,0,1,-1,0,100,-100,T,358
486,Forest,Cadian,2,1,1,196,56,140,CT,358
487,Forest,Cadian,0,0,0,0,0,0,T,358
488,Deep T Spawn T Ramp,Cadian,0,0,0,0,0,0,CT,358
489,Deep T Spawn T Ramp,Cadian,0,0,0,0,0,0,T,358
490,Balcony Boaxes,Cadian,0,0,0,0,0,0,CT,358
491,Balcony Boaxes,Cadian,0,1,-1,0,100,-100,T,358
492,Close Right Market Window,Cadian,0,0,0,0,0,0,CT,358
493,Close Right Market Window,Cadian,0,0,0,0,0,0,T,358
494,Under window B apps,Cadian,0,0,0,0,0,0,CT,358
495,Under window B apps,Cadian,0,0,0,0,0,0,T,358
496,Sandwhich,Cadian,0,1,-1,0,100,-100,CT,358
497,Sandwhich,Cadian,0,0,0,0,25,-25,T,358
498,Bench Closer To Jungle,Cadian,0,0,0,62,0,62,CT,358
499,Bench Closer To Jungle,Cadian,0,0,0,0,0,0,T,358
500,Under balcony,Cadian,0,0,0,0,0,0,CT,358
501,Under balcony,Cadian,0,0,0,0,0,0,T,358
502,Right Side Snipers Nest,Cadian,0,0,0,2,71,-69,CT,358
503,Right Side Snipers Nest,Cadian,0,0,0,0,0,0,T,358
504,Left Side corner deep jungle,Cadian,2,0,2,164,0,164,CT,358
505,Left Side corner deep jungle,Cadian,0,0,0,0,0,0,T,358
506,Tucked in corner Market,Cadian,0,1,-1,0,100,-100,CT,358
507,Tucked in corner Market,Cadian,0,0,0,0,0,0,T,358
508,Connector behind box,Cadian,2,1,1,200,11,189,CT,358
509,Connector behind box,Cadian,0,0,0,0,0,0,T,358
510,CT Spawn,Cadian,0,1,-1,6,100,-94,CT,358
511,CT Spawn,Cadian,1,0,1,100,0,100,T,358
512,Right Side Connector,Cadian,1,0,1,193,184,9,CT,358
513,Right Side Connector,Cadian,0,1,-1,23,100,-77,T,358
514,Apartments Right CT Corner,Cadian,0,0,0,0,0,0,CT,358
515,Apartments Right CT Corner,Cadian,2,0,2,200,0,200,T,358
516,GasStation,Cadian,0,0,0,0,0,0,CT,358
517,GasStation,Cadian,0,1,-1,0,67,-67,T,358
518,Flowerpot CT,Cadian,0,1,-1,81,32,49,CT,358
519,Flowerpot CT,Cadian,0,0,0,0,0,0,T,358
520,CT Side Apps,Refresh,0,3,-3,88,273,-185,CT,172
521,CT Side Apps,Refresh,4,5,-1,442,707,-265,T,172
522,Left Side Platform,Refresh,0,1,-1,0,12,-12,CT,172
523,Left Side Platform,Refresh,3,3,0,263,292,-29,T,172
524,Top Balcony,Refresh,5,2,3,499,173,326,CT,172
525,Top Balcony,Refresh,3,2,1,319,288,31,T,172
526,Default A,Refresh,1,3,-2,228,284,-56,CT,172
527,Default A,Refresh,0,1,-1,12,123,-111,T,172
528,Bottom Stairs,Refresh,1,0,1,131,49,82,CT,172
529,Bottom Stairs,Refresh,2,2,0,208,171,37,T,172
530,CT Catwalk,Refresh,3,1,2,293,100,193,CT,172
531,CT Catwalk,Refresh,1,3,-2,110,203,-93,T,172
532,Bench,Refresh,1,1,0,116,100,16,CT,172
533,Bench,Refresh,2,1,1,110,67,43,T,172
534,Back B Site Peeking Apps/Plat,Refresh,1,0,1,28,14,14,CT,172
535,Back B Site Peeking Apps/Plat,Refresh,0,0,0,25,39,-14,T,172
536,Mid Close Connector,Refresh,1,2,-1,80,157,-77,CT,172
537,Mid Close Connector,Refresh,3,1,2,288,58,230,T,172
538,A Ramp,Refresh,3,0,3,278,0,278,CT,172
539,A Ramp,Refresh,0,1,-1,0,100,-100,T,172
540,Underneath B apps plat,Refresh,3,1,2,335,162,173,CT,172
541,Underneath B apps plat,Refresh,2,1,1,172,78,94,T,172
542,Ticketbooth ,Refresh,0,0,0,0,0,0,CT,172
543,Ticketbooth ,Refresh,0,1,-1,0,100,-100,T,172
544,Underpass,Refresh,1,0,1,100,28,72,CT,172
545,Underpass,Refresh,1,0,1,73,23,50,T,172
546,A Site,Refresh,2,2,0,320,239,81,CT,172
547,A Site,Refresh,0,1,-1,27,41,-14,T,172
548,Close Left CT A Ramp,Refresh,0,3,-3,192,237,-45,CT,172
549,Close Left CT A Ramp,Refresh,0,1,-1,0,100,-100,T,172
550,Bottom Connector,Refresh,0,0,0,131,9,122,CT,172
551,Bottom Connector,Refresh,0,1,-1,12,79,-67,T,172
552,Snipers Nest,Refresh,0,2,-2,26,191,-165,CT,172
553,Snipers Nest,Refresh,1,1,0,123,100,23,T,172
554,Close Market door,Refresh,0,1,-1,43,125,-82,CT,172
555,Close Market door,Refresh,1,0,1,94,27,67,T,172
556,Snipers Palace Peek,Refresh,1,2,-1,130,284,-154,CT,172
557,Snipers Palace Peek,Refresh,0,0,0,0,0,0,T,172
558,Leftside Connector,Refresh,0,2,-2,27,132,-105,CT,172
559,Leftside Connector,Refresh,0,0,0,0,0,0,T,172
560,Deep Catwalk,Refresh,7,1,6,638,100,538,CT,172
561,Deep Catwalk,Refresh,0,1,-1,0,100,-100,T,172
562,Close A Ramp,Refresh,1,1,0,7,15,-8,CT,172
563,Close A Ramp,Refresh,0,3,-3,62,302,-240,T,172
564,B Bombsite Cross to Catwalk,Refresh,1,0,1,100,0,100,CT,172
565,B Bombsite Cross to Catwalk,Refresh,2,2,0,242,276,-34,T,172
566,Deep Palace,Refresh,0,1,-1,91,193,-102,CT,172
567,Deep Palace,Refresh,1,2,-1,191,177,14,T,172
568,Deep Jungle,Refresh,0,1,-1,53,100,-47,CT,172
569,Deep Jungle,Refresh,2,1,1,252,165,87,T,172
570,Semi Elevated CT Van,Refresh,2,1,1,177,100,77,CT,172
571,Semi Elevated CT Van,Refresh,0,1,-1,14,48,-34,T,172
572,Back Left B Site From T's' Perspective,Refresh,3,1,2,327,73,254,CT,172
573,Back Left B Site From T's' Perspective,Refresh,1,0,1,157,0,157,T,172
574,CT Outside Market,Refresh,0,1,-1,0,100,-100,CT,172
575,CT Outside Market,Refresh,0,0,0,0,0,0,T,172
576,Arch,Refresh,4,3,1,387,293,94,CT,172
577,Arch,Refresh,0,0,0,0,0,0,T,172
578,Deep CT,Refresh,0,2,-2,0,200,-200,CT,172
579,Deep CT,Refresh,0,0,0,0,0,0,T,172
580,Top Mid Left Side,Refresh,0,0,0,74,0,74,CT,172
581,Top Mid Left Side,Refresh,2,0,2,174,0,174,T,172
582,T Spawn A Ramp,Refresh,0,1,-1,43,100,-57,CT,172
583,T Spawn A Ramp,Refresh,0,1,-1,0,100,-100,T,172
584,Market Window Peek,Refresh,0,1,-1,0,99,-99,CT,172
585,Market Window Peek,Refresh,0,1,-1,0,9,-9,T,172
586,T Palace Stairs Peek,Refresh,0,0,0,0,0,0,CT,172
587,T Palace Stairs Peek,Refresh,2,1,1,192,123,69,T,172
588,A Site Exposed to Stairs Connector Cat,Refresh,1,2,-1,142,200,-58,CT,172
589,A Site Exposed to Stairs Connector Cat,Refresh,0,1,-1,63,92,-29,T,172
590,Right Side Platform,Refresh,2,1,1,200,100,100,CT,172
591,Right Side Platform,Refresh,0,0,0,0,0,0,T,172
592,Top Mid towards Apps,Refresh,1,0,1,26,0,26,CT,172
593,Top Mid towards Apps,Refresh,0,0,0,0,0,0,T,172
594,Catwalk Connector Peek,Refresh,7,1,6,596,270,326,CT,172
595,Catwalk Connector Peek,Refresh,0,0,0,0,0,0,T,172
596,Top Mid,Refresh,4,0,4,412,122,290,CT,172
597,Top Mid,Refresh,1,1,0,31,142,-111,T,172
598,Ninja,Refresh,0,1,-1,48,67,-19,CT,172
599,Ninja,Refresh,0,1,-1,29,30,-1,T,172
600,Bottom Mid Ladder Room Peek,Refresh,0,0,0,0,0,0,CT,172
601,Bottom Mid Ladder Room Peek,Refresh,0,0,0,16,16,0,T,172
602,market,Refresh,3,1,2,237,174,63,CT,172
603,market,Refresh,1,1,0,100,84,16,T,172
604,B Site Default Plant,Refresh,0,0,0,0,0,0,CT,172
605,B Site Default Plant,Refresh,0,1,-1,0,78,-78,T,172
606,Triple Box,Refresh,0,0,0,18,0,18,CT,172
607,Triple Box,Refresh,1,1,0,47,122,-75,T,172
608,Inside Market Doors,Refresh,2,0,2,103,0,103,CT,172
609,Inside Market Doors,Refresh,0,0,0,0,0,0,T,172
610,Middle Bench,Refresh,0,2,-2,48,170,-122,CT,172
611,Middle Bench,Refresh,0,0,0,0,0,0,T,172
612,Stairs Palace Peek,Refresh,1,1,0,53,100,-47,CT,172
613,Stairs Palace Peek,Refresh,0,0,0,0,0,0,T,172
614,Behind Big Boxes,Refresh,0,0,0,0,0,0,CT,172
615,Behind Big Boxes,Refresh,0,0,0,0,0,0,T,172
616,Elevated Snipers Awp Peek,Refresh,0,1,-1,23,100,-77,CT,172
617,Elevated Snipers Awp Peek,Refresh,0,0,0,0,0,0,T,172
618,Bottom Mid Boosting Snipers,Refresh,0,0,0,0,0,0,CT,172
619,Bottom Mid Boosting Snipers,Refresh,0,0,0,0,0,0,T,172
620,Firebox,Refresh,0,0,0,0,0,0,CT,172
621,Firebox,Refresh,0,0,0,0,0,0,T,172
622,Forest,Refresh,0,0,0,0,0,0,CT,172
623,Forest,Refresh,0,0,0,0,33,-33,T,172
624,Close Right Market Window,Refresh,0,0,0,0,0,0,CT,172
625,Close Right Market Window,Refresh,1,1,0,152,100,52,T,172
626,Top STairs,Refresh,2,0,2,156,26,130,CT,172
627,Top STairs,Refresh,1,0,1,22,23,-1,T,172
628,Van Barrel Peek,Refresh,0,0,0,0,0,0,CT,172
629,Van Barrel Peek,Refresh,0,0,0,0,0,0,T,172
630,Back Right B Site from T's Perspective,Refresh,2,0,2,191,62,129,CT,172
631,Back Right B Site from T's Perspective,Refresh,0,1,-1,0,44,-44,T,172
632,Jungle Plant,Refresh,0,0,0,0,0,0,CT,172
633,Jungle Plant,Refresh,0,0,0,0,0,0,T,172
634,Apartments Right CT Corner,Refresh,0,0,0,0,0,0,CT,172
635,Apartments Right CT Corner,Refresh,1,0,1,100,0,100,T,172
636,Ladder Room Catwalk Side,Refresh,0,0,0,0,0,0,CT,172
637,Ladder Room Catwalk Side,Refresh,1,0,1,60,2,58,T,172
638,Chair,Refresh,0,0,0,0,0,0,CT,172
639,Chair,Refresh,0,0,0,0,0,0,T,172
640,T Deep Apps Underpass/Apps Peek,Refresh,0,0,0,0,0,0,CT,172
641,T Deep Apps Underpass/Apps Peek,Refresh,1,0,1,100,4,96,T,172
642,Stairs Smoke Platform,Refresh,0,0,0,0,0,0,CT,172
643,Stairs Smoke Platform,Refresh,0,0,0,0,0,0,T,172
644,Top Mid Right Side,Refresh,0,0,0,0,0,0,CT,172
645,Top Mid Right Side,Refresh,0,0,0,0,29,-29,T,172
646,Catwalk Plant B Site,Refresh,0,0,0,0,0,0,CT,172
647,Catwalk Plant B Site,Refresh,1,0,1,100,53,47,T,172
648,Top Van,Refresh,0,1,-1,0,100,-100,CT,172
649,Top Van,Refresh,0,0,0,0,14,-14,T,172
650,Murder Hole,Refresh,1,1,0,100,100,0,CT,172
651,Murder Hole,Refresh,1,0,1,100,16,84,T,172
652,Right Side Snipers Nest,Refresh,1,1,0,36,100,-64,CT,172
653,Right Side Snipers Nest,Refresh,0,0,0,0,0,0,T,172
654,B site Market Plant,Refresh,0,0,0,0,0,0,CT,172
655,B site Market Plant,Refresh,0,0,0,0,0,0,T,172
656,Sandwhich,Refresh,0,0,0,0,0,0,CT,172
657,Sandwhich,Refresh,0,0,0,0,0,0,T,172
658,Default A,Sjuush,7,6,1,926,600,326,CT,172
659,Default A,Sjuush,2,2,0,278,389,-111,T,172
660,Ticketbooth ,Sjuush,14,8,6,1515,1122,393,CT,172
661,Ticketbooth ,Sjuush,0,0,0,0,0,0,T,172
662,T Spawn A Ramp,Sjuush,3,2,1,279,200,79,CT,172
663,T Spawn A Ramp,Sjuush,0,2,-2,26,158,-132,T,172
664,A Ramp,Sjuush,5,4,1,489,459,30,CT,172
665,A Ramp,Sjuush,1,0,1,116,68,48,T,172
666,Top Balcony,Sjuush,7,3,4,783,394,389,CT,172
667,Top Balcony,Sjuush,1,1,0,243,171,72,T,172
668,T Palace Stairs Peek,Sjuush,0,0,0,0,0,0,CT,172
669,T Palace Stairs Peek,Sjuush,1,2,-1,126,262,-136,T,172
670,Close A Ramp,Sjuush,4,3,1,413,276,137,CT,172
671,Close A Ramp,Sjuush,1,0,1,73,66,7,T,172
672,market,Sjuush,2,2,0,104,99,5,CT,172
673,market,Sjuush,1,2,-1,41,114,-73,T,172
674,Triple Box,Sjuush,0,2,-2,8,202,-194,CT,172
675,Triple Box,Sjuush,0,2,-2,27,88,-61,T,172
676,Back B Site Peeking Apps/Plat,Sjuush,0,0,0,0,0,0,CT,172
677,Back B Site Peeking Apps/Plat,Sjuush,1,5,-4,115,409,-294,T,172
678,Bottom Stairs,Sjuush,4,2,2,411,216,195,CT,172
679,Bottom Stairs,Sjuush,0,1,-1,38,100,-62,T,172
680,Bottom Connector,Sjuush,0,0,0,0,13,-13,CT,172
681,Bottom Connector,Sjuush,2,2,0,198,115,83,T,172
682,CT Side Apps,Sjuush,0,0,0,0,0,0,CT,172
683,CT Side Apps,Sjuush,2,4,-2,267,484,-217,T,172
684,Deep Palace,Sjuush,1,1,0,192,100,92,CT,172
685,Deep Palace,Sjuush,0,2,-2,124,200,-76,T,172
686,Left Side Platform,Sjuush,0,0,0,0,0,0,CT,172
687,Left Side Platform,Sjuush,1,3,-2,139,208,-69,T,172
688,A Site,Sjuush,6,1,5,557,172,385,CT,172
689,A Site,Sjuush,0,2,-2,65,177,-112,T,172
690,CT Deep Catwalk Mid peek,Sjuush,0,0,0,0,11,-11,CT,172
691,CT Deep Catwalk Mid peek,Sjuush,0,0,0,8,0,8,T,172
692,B Bombsite Cross to Catwalk,Sjuush,0,0,0,0,0,0,CT,172
693,B Bombsite Cross to Catwalk,Sjuush,2,1,1,153,179,-26,T,172
694,Top Mid Left Side,Sjuush,0,0,0,0,0,0,CT,172
695,Top Mid Left Side,Sjuush,0,1,-1,202,175,27,T,172
696,Top Connector,Sjuush,0,1,-1,0,111,-111,CT,172
697,Top Connector,Sjuush,1,0,1,36,0,36,T,172
698,Bench,Sjuush,1,2,-1,100,200,-100,CT,172
699,Bench,Sjuush,2,1,1,162,94,68,T,172
700,Deep CT,Sjuush,2,3,-1,286,300,-14,CT,172
701,Deep CT,Sjuush,0,0,0,0,0,0,T,172
702,Sandwhich,Sjuush,0,0,0,7,0,7,CT,172
703,Sandwhich,Sjuush,0,0,0,0,0,0,T,172
704,Close Left CT A Ramp,Sjuush,1,2,-1,174,225,-51,CT,172
705,Close Left CT A Ramp,Sjuush,1,1,0,100,100,0,T,172
706,Catwalk Connector Peek,Sjuush,0,0,0,0,0,0,CT,172
707,Catwalk Connector Peek,Sjuush,3,0,3,104,0,104,T,172
708,Under balcony,Sjuush,2,1,1,167,47,120,CT,172
709,Under balcony,Sjuush,0,1,-1,0,88,-88,T,172
710,Back Left B Site From T's' Perspective,Sjuush,0,2,-2,0,200,-200,CT,172
711,Back Left B Site From T's' Perspective,Sjuush,2,0,2,99,1,98,T,172
712,Catwalk Plant B Site,Sjuush,0,0,0,0,0,0,CT,172
713,Catwalk Plant B Site,Sjuush,1,3,-2,129,190,-61,T,172
714,Mid Close Connector,Sjuush,1,2,-1,100,239,-139,CT,172
715,Mid Close Connector,Sjuush,1,1,0,226,69,157,T,172
716,Tetris,Sjuush,0,0,0,0,0,0,CT,172
717,Tetris,Sjuush,0,0,0,0,0,0,T,172
718,CT Left Side,Sjuush,2,2,0,322,293,29,CT,172
719,CT Left Side,Sjuush,0,0,0,0,0,0,T,172
720,Top STairs,Sjuush,0,1,-1,0,100,-100,CT,172
721,Top STairs,Sjuush,0,0,0,0,0,0,T,172
722,Right Side Connector,Sjuush,0,0,0,0,0,0,CT,172
723,Right Side Connector,Sjuush,0,0,0,64,0,64,T,172
724,A Site Exposed to Stairs Connector Cat,Sjuush,0,0,0,69,0,69,CT,172
725,A Site Exposed to Stairs Connector Cat,Sjuush,4,0,4,330,47,283,T,172
726,Top Mid,Sjuush,1,1,0,122,100,22,CT,172
727,Top Mid,Sjuush,0,1,-1,11,53,-42,T,172
728,Deep Jungle,Sjuush,0,0,0,0,0,0,CT,172
729,Deep Jungle,Sjuush,1,0,1,88,38,50,T,172
730,Leftside Connector,Sjuush,0,2,-2,82,200,-118,CT,172
731,Leftside Connector,Sjuush,0,0,0,0,0,0,T,172
732,Balcony Boaxes,Sjuush,0,1,-1,51,127,-76,CT,172
733,Balcony Boaxes,Sjuush,0,1,-1,0,92,-92,T,172
734,Back Right B Site from T's Perspective,Sjuush,0,0,0,0,0,0,CT,172
735,Back Right B Site from T's Perspective,Sjuush,0,0,0,0,0,0,T,172
736,Deep Catwalk,Sjuush,0,0,0,0,0,0,CT,172
737,Deep Catwalk,Sjuush,0,0,0,0,102,-102,T,172
738,Close Market Window,Sjuush,0,0,0,0,0,0,CT,172
739,Close Market Window,Sjuush,0,0,0,0,0,0,T,172
740,Catwalk T Aparments Peek,Sjuush,0,0,0,0,0,0,CT,172
741,Catwalk T Aparments Peek,Sjuush,0,1,-1,0,7,-7,T,172
742,Murder Hole,Sjuush,0,0,0,0,0,0,CT,172
743,Murder Hole,Sjuush,0,0,0,0,0,0,T,172
744,Deep T Spawn T Ramp,Sjuush,1,0,1,100,0,100,CT,172
745,Deep T Spawn T Ramp,Sjuush,0,0,0,0,0,0,T,172
746,Van Barrel Peek,Sjuush,0,0,0,0,0,0,CT,172
747,Van Barrel Peek,Sjuush,0,0,0,0,0,0,T,172
748,Stairs Palace Peek,Sjuush,1,0,1,100,0,100,CT,172
749,Stairs Palace Peek,Sjuush,0,0,0,0,0,0,T,172
750,Underneath B apps plat,Sjuush,0,0,0,0,0,0,CT,172
751,Underneath B apps plat,Sjuush,1,0,1,100,17,83,T,172
752,CT Spawn,Sjuush,1,1,0,19,27,-8,CT,172
753,CT Spawn,Sjuush,1,0,1,100,0,100,T,172
754,Deep T Apps Underpass STairs,Sjuush,0,1,-1,21,100,-79,CT,172
755,Deep T Apps Underpass STairs,Sjuush,0,0,0,0,0,0,T,172
756,Underpass,Sjuush,0,0,0,0,0,0,CT,172
757,Underpass,Sjuush,0,1,-1,44,136,-92,T,172
758,Apartments Right CT Corner,Sjuush,0,0,0,0,0,0,CT,172
759,Apartments Right CT Corner,Sjuush,0,1,-1,0,100,-100,T,172
760,CT Outside Market,Sjuush,0,0,0,0,0,0,CT,172
761,CT Outside Market,Sjuush,2,1,1,200,90,110,T,172
762,T Deep Apps Underpass/Apps Peek,Sjuush,0,0,0,0,0,0,CT,172
763,T Deep Apps Underpass/Apps Peek,Sjuush,0,0,0,0,0,0,T,172
764,B Site Default Plant,Sjuush,0,1,-1,32,100,-68,CT,172
765,B Site Default Plant,Sjuush,0,0,0,8,0,8,T,172
766,Left Side corner deep jungle,Sjuush,0,0,0,0,0,0,CT,172
767,Left Side corner deep jungle,Sjuush,0,1,-1,12,55,-43,T,172
768,Top Mid Right Side,Sjuush,0,0,0,0,0,0,CT,172
769,Top Mid Right Side,Sjuush,0,0,0,0,0,0,T,172
770,Close Market door,Sjuush,1,0,1,80,0,80,CT,172
771,Close Market door,Sjuush,0,0,0,0,0,0,T,172
772,Connector behind box,Sjuush,0,1,-1,63,48,15,CT,172
773,Connector behind box,Sjuush,0,0,0,0,0,0,T,172
774,Top Van,Sjuush,0,0,0,0,0,0,CT,172
775,Top Van,Sjuush,0,0,0,0,0,0,T,172
776,Bottom Mid Ladder Room Peek,Sjuush,0,0,0,0,0,0,CT,172
777,Bottom Mid Ladder Room Peek,Sjuush,0,1,-1,0,136,-136,T,172
778,Arch,Sjuush,0,0,0,0,0,0,CT,172
779,Arch,Sjuush,1,0,1,100,86,14,T,172
780,B site Market Plant,Sjuush,0,0,0,0,0,0,CT,172
781,B site Market Plant,Sjuush,1,1,0,88,56,32,T,172
782,Right Side Platform,Sjuush,0,0,0,0,0,0,CT,172
783,Right Side Platform,Sjuush,0,1,-1,51,100,-49,T,172
784,Snipers Palace Peek,Sjuush,0,0,0,0,25,-25,CT,172
785,Snipers Palace Peek,Sjuush,0,0,0,0,0,0,T,172
786,Firebox,Sjuush,0,0,0,0,0,0,CT,172
787,Firebox,Sjuush,0,0,0,0,0,0,T,172
788,CT Catwalk,Sjuush,0,0,0,0,2,-2,CT,172
789,CT Catwalk,Sjuush,0,0,0,0,0,0,T,172
790,A Site Exposed to Stairs Connector Cat,B0rup,0,3,-3,159,300,-141,CT,186
791,A Site Exposed to Stairs Connector Cat,B0rup,1,6,-5,46,430,-384,T,186
792,A Ramp,B0rup,0,4,-4,90,426,-336,CT,186
793,A Ramp,B0rup,1,3,-2,158,491,-333,T,186
794,Mid Close Connector,B0rup,1,2,-1,100,200,-100,CT,186
795,Mid Close Connector,B0rup,1,7,-6,104,649,-545,T,186
796,Default A,B0rup,7,4,3,883,486,397,CT,186
797,Default A,B0rup,2,3,-1,259,312,-53,T,186
798,Bottom Stairs,B0rup,0,1,-1,34,189,-155,CT,186
799,Bottom Stairs,B0rup,1,6,-5,137,542,-405,T,186
800,Top Balcony,B0rup,6,3,3,554,398,156,CT,186
801,Top Balcony,B0rup,1,2,-1,108,293,-185,T,186
802,Deep Jungle,B0rup,1,4,-3,138,302,-164,CT,186
803,Deep Jungle,B0rup,3,0,3,300,64,236,T,186
804,Ticketbooth ,B0rup,3,3,0,326,396,-70,CT,186
805,Ticketbooth ,B0rup,2,1,1,237,100,137,T,186
806,Close A Ramp,B0rup,1,3,-2,143,363,-220,CT,186
807,Close A Ramp,B0rup,1,1,0,140,100,40,T,186
808,CT Side Apps,B0rup,0,0,0,0,0,0,CT,186
809,CT Side Apps,B0rup,1,5,-4,127,427,-300,T,186
810,A Site,B0rup,2,0,2,57,0,57,CT,186
811,A Site,B0rup,2,1,1,141,235,-94,T,186
812,Bench,B0rup,3,3,0,396,185,211,CT,186
813,Bench,B0rup,0,1,-1,0,22,-22,T,186
814,Top Connector,B0rup,0,3,-3,39,250,-211,CT,186
815,Top Connector,B0rup,2,0,2,115,47,68,T,186
816,Triple Box,B0rup,3,2,1,293,286,7,CT,186
817,Triple Box,B0rup,1,1,0,127,100,27,T,186
818,Back B Site Peeking Apps/Plat,B0rup,0,0,0,82,0,82,CT,186
819,Back B Site Peeking Apps/Plat,B0rup,1,4,-3,165,400,-235,T,186
820,Tetris,B0rup,0,1,-1,0,9,-9,CT,186
821,Tetris,B0rup,0,2,-2,0,200,-200,T,186
822,Snipers Palace Peek,B0rup,1,0,1,100,26,74,CT,186
823,Snipers Palace Peek,B0rup,0,1,-1,0,100,-100,T,186
824,CT Catwalk,B0rup,1,2,-1,62,47,15,CT,186
825,CT Catwalk,B0rup,1,2,-1,100,174,-74,T,186
826,Deep T Apps,B0rup,1,0,1,100,62,38,CT,186
827,Deep T Apps,B0rup,1,1,0,51,164,-113,T,186
828,Ladder Room Catwalk Side,B0rup,3,3,0,231,389,-158,CT,186
829,Ladder Room Catwalk Side,B0rup,1,0,1,189,0,189,T,186
830,Leftside Connector,B0rup,0,1,-1,88,100,-12,CT,186
831,Leftside Connector,B0rup,0,0,0,0,0,0,T,186
832,Catwalk T Aparments Peek,B0rup,0,1,-1,215,205,10,CT,186
833,Catwalk T Aparments Peek,B0rup,0,0,0,0,0,0,T,186
834,Bottom Connector,B0rup,0,0,0,0,0,0,CT,186
835,Bottom Connector,B0rup,2,1,1,235,164,71,T,186
836,B Site Default Plant,B0rup,0,2,-2,0,168,-168,CT,186
837,B Site Default Plant,B0rup,0,0,0,0,0,0,T,186
838,Deep Catwalk,B0rup,1,1,0,133,122,11,CT,186
839,Deep Catwalk,B0rup,0,0,0,0,0,0,T,186
840,Left Side Platform,B0rup,1,0,1,100,0,100,CT,186
841,Left Side Platform,B0rup,0,0,0,0,24,-24,T,186
842,B Bombsite Cross to Catwalk,B0rup,0,1,-1,56,100,-44,CT,186
843,B Bombsite Cross to Catwalk,B0rup,1,0,1,109,0,109,T,186
844,Underpass,B0rup,1,1,0,181,100,81,CT,186
845,Underpass,B0rup,1,0,1,103,47,56,T,186
846,Catwalk Plant B Site,B0rup,0,1,-1,67,100,-33,CT,186
847,Catwalk Plant B Site,B0rup,0,1,-1,54,100,-46,T,186
848,Under balcony,B0rup,0,0,0,0,13,-13,CT,186
849,Under balcony,B0rup,0,0,0,0,0,0,T,186
850,T Palace Stairs Peek,B0rup,0,0,0,3,0,3,CT,186
851,T Palace Stairs Peek,B0rup,1,1,0,155,7,148,T,186
852,Deep Palace,B0rup,1,0,1,100,37,63,CT,186
853,Deep Palace,B0rup,1,1,0,97,96,1,T,186
854,Under window B apps,B0rup,1,1,0,153,100,53,CT,186
855,Under window B apps,B0rup,1,1,0,100,100,0,T,186
856,Snipers Nest,B0rup,0,3,-3,0,282,-282,CT,186
857,Snipers Nest,B0rup,1,0,1,11,0,11,T,186
858,CT Deep Catwalk Mid peek,B0rup,2,1,1,325,72,253,CT,186
859,CT Deep Catwalk Mid peek,B0rup,0,0,0,0,26,-26,T,186
860,Register Market,B0rup,1,1,0,162,100,62,CT,186
861,Register Market,B0rup,0,1,-1,27,98,-71,T,186
862,Top Mid towards Apps,B0rup,0,0,0,0,0,0,CT,186
863,Top Mid towards Apps,B0rup,0,1,-1,0,100,-100,T,186
864,Right Side Snipers Nest,B0rup,0,1,-1,76,42,34,CT,186
865,Right Side Snipers Nest,B0rup,0,0,0,0,76,-76,T,186
866,Close Market door,B0rup,0,0,0,0,61,-61,CT,186
867,Close Market door,B0rup,0,0,0,0,0,0,T,186
868,CT Left Side,B0rup,0,1,-1,0,30,-30,CT,186
869,CT Left Side,B0rup,0,0,0,0,0,0,T,186
870,Market Window Peek,B0rup,1,2,-1,71,410,-339,CT,186
871,Market Window Peek,B0rup,0,0,0,0,0,0,T,186
872,Sandwhich,B0rup,0,0,0,0,0,0,CT,186
873,Sandwhich,B0rup,0,0,0,0,0,0,T,186
874,Connector behind box,B0rup,0,0,0,0,0,0,CT,186
875,Connector behind box,B0rup,0,1,-1,0,100,-100,T,186
876,Middle Bench,B0rup,0,0,0,34,0,34,CT,186
877,Middle Bench,B0rup,0,0,0,0,0,0,T,186
878,Close Left CT A Ramp,B0rup,1,0,1,100,0,100,CT,186
879,Close Left CT A Ramp,B0rup,1,1,0,100,61,39,T,186
880,Murder Hole,B0rup,1,0,1,74,0,74,CT,186
881,Murder Hole,B0rup,0,1,-1,27,99,-72,T,186
882,Stairs Palace Peek,B0rup,0,1,-1,72,100,-28,CT,186
883,Stairs Palace Peek,B0rup,0,0,0,0,0,0,T,186
884,BombsiteB,B0rup,0,0,0,0,0,0,CT,186
885,BombsiteB,B0rup,0,1,-1,0,24,-24,T,186
886,Back Left B Site From T's' Perspective,B0rup,0,0,0,0,0,0,CT,186
887,Back Left B Site From T's' Perspective,B0rup,1,0,1,100,0,100,T,186
888,Deep T Apps Underpass STairs,B0rup,0,0,0,0,0,0,CT,186
889,Deep T Apps Underpass STairs,B0rup,2,0,2,200,27,173,T,186
890,Firebox,B0rup,0,0,0,0,0,0,CT,186
891,Firebox,B0rup,0,0,0,0,0,0,T,186
892,Right Side Connector,B0rup,0,0,0,0,0,0,CT,186
893,Right Side Connector,B0rup,2,0,2,200,0,200,T,186
894,Deep CT,B0rup,1,1,0,42,100,-58,CT,186
895,Deep CT,B0rup,0,0,0,0,0,0,T,186
896,Behind Big Boxes,B0rup,0,0,0,0,0,0,CT,186
897,Behind Big Boxes,B0rup,0,0,0,0,0,0,T,186
898,Right Side Platform,B0rup,0,0,0,0,0,0,CT,186
899,Right Side Platform,B0rup,1,0,1,145,90,55,T,186
900,Top Mid Boxes Left Side Peek,B0rup,0,0,0,0,0,0,CT,186
901,Top Mid Boxes Left Side Peek,B0rup,0,1,-1,0,100,-100,T,186
902,Top STairs,B0rup,1,0,1,10,0,10,CT,186
903,Top STairs,B0rup,0,0,0,0,0,0,T,186
904,Apartments Right CT Corner,B0rup,0,0,0,0,0,0,CT,186
905,Apartments Right CT Corner,B0rup,1,0,1,73,0,73,T,186
906,B site Market Plant,B0rup,0,0,0,80,0,80,CT,186
907,B site Market Plant,B0rup,0,0,0,0,0,0,T,186
908,Ninja,B0rup,1,0,1,180,0,180,CT,186
909,Ninja,B0rup,0,0,0,46,0,46,T,186
910,CT Outside Market,B0rup,0,0,0,52,0,52,CT,186
911,CT Outside Market,B0rup,0,0,0,0,0,0,T,186
912,T Deep Apps Underpass/Apps Peek,B0rup,0,0,0,0,0,0,CT,186
913,T Deep Apps Underpass/Apps Peek,B0rup,2,1,1,298,150,148,T,186
914,Left Side corner deep jungle,B0rup,1,0,1,90,78,12,CT,186
915,Left Side corner deep jungle,B0rup,0,1,-1,24,78,-54,T,186
916,Balcony Boaxes,B0rup,0,0,0,55,0,55,CT,186
917,Balcony Boaxes,B0rup,0,1,-1,0,100,-100,T,186
