,Location,Player,Kills,Deaths,K/D,Damage Dealt,Damage Taken,Damage Differential,Side,Total Rounds
0,Top Balcony,Elige,3,4,-1,447,401,46,CT,196
1,Top Balcony,Elige,0,2,-2,87,112,-25,T,196
2,Deep Jungle,Elige,2,3,-1,316,326,-10,CT,196
3,Deep Jungle,Elige,3,4,-1,257,341,-84,T,196
4,CT Deep Catwalk Mid peek,Elige,0,2,-2,128,87,41,CT,196
5,CT Deep Catwalk Mid peek,Elige,1,1,0,179,159,20,T,196
6,Ticketbooth ,Elige,7,4,3,642,438,204,CT,196
7,Ticketbooth ,Elige,1,0,1,23,0,23,T,196
8,Bottom Stairs,Elige,4,6,-2,493,624,-131,CT,196
9,Bottom Stairs,Elige,2,1,1,275,96,179,T,196
10,Triple Box,Elige,3,1,2,271,85,186,CT,196
11,Triple Box,Elige,0,0,0,0,0,0,T,196
12,A Site,Elige,1,1,0,270,100,170,CT,196
13,A Site,Elige,4,2,2,444,151,293,T,196
14,Mid Close Connector,Elige,0,2,-2,12,116,-104,CT,196
15,Mid Close Connector,Elige,2,1,1,229,159,70,T,196
16,Tetris,Elige,0,0,0,41,0,41,CT,196
17,Tetris,Elige,3,2,1,311,295,16,T,196
18,Deep Palace,Elige,2,1,1,202,127,75,CT,196
19,Deep Palace,Elige,1,1,0,100,69,31,T,196
20,Bottom Connector,Elige,3,2,1,318,112,206,CT,196
21,Bottom Connector,Elige,4,3,1,439,274,165,T,196
22,Snipers Nest,Elige,1,4,-3,308,295,13,CT,196
23,Snipers Nest,Elige,0,0,0,26,19,7,T,196
24,Catwalk Connector Peek,Elige,0,0,0,15,0,15,CT,196
25,Catwalk Connector Peek,Elige,1,2,-1,109,307,-198,T,196
26,Top Mid towards Apps,Elige,0,0,0,0,0,0,CT,196
27,Top Mid towards Apps,Elige,0,2,-2,205,156,49,T,196
28,Top Mid,Elige,3,2,1,292,288,4,CT,196
29,Top Mid,Elige,0,0,0,10,0,10,T,196
30,T Palace Stairs Peek,Elige,1,2,-1,148,173,-25,CT,196
31,T Palace Stairs Peek,Elige,0,0,0,26,7,19,T,196
32,Top Mid Left Side,Elige,2,0,2,261,0,261,CT,196
33,Top Mid Left Side,Elige,1,4,-3,284,696,-412,T,196
34,Left Side Platform,Elige,0,0,0,0,0,0,CT,196
35,Left Side Platform,Elige,0,1,-1,34,152,-118,T,196
36,A Site Exposed to Stairs Connector Cat,Elige,6,2,4,484,148,336,CT,196
37,A Site Exposed to Stairs Connector Cat,Elige,1,1,0,125,111,14,T,196
38,Right Side Connector,Elige,2,1,1,382,202,180,CT,196
39,Right Side Connector,Elige,1,0,1,100,93,7,T,196
40,A Ramp,Elige,0,0,0,0,0,0,CT,196
41,A Ramp,Elige,0,2,-2,46,200,-154,T,196
42,Catwalk T Aparments Peek,Elige,2,1,1,252,126,126,CT,196
43,Catwalk T Aparments Peek,Elige,0,0,0,0,0,0,T,196
44,Ninja,Elige,0,0,0,0,0,0,CT,196
45,Ninja,Elige,0,0,0,0,0,0,T,196
46,Default A,Elige,2,2,0,203,119,84,CT,196
47,Default A,Elige,2,1,1,137,15,122,T,196
48,Top Mid Catwalk,Elige,1,2,-1,74,200,-126,CT,196
49,Top Mid Catwalk,Elige,1,0,1,92,69,23,T,196
50,Underpass,Elige,2,1,1,251,181,70,CT,196
51,Underpass,Elige,2,1,1,157,122,35,T,196
52,Top Connector,Elige,2,1,1,286,192,94,CT,196
53,Top Connector,Elige,1,2,-1,134,230,-96,T,196
54,Deep Catwalk,Elige,2,1,1,103,100,3,CT,196
55,Deep Catwalk,Elige,5,3,2,522,328,194,T,196
56,Close A Ramp,Elige,3,1,2,212,100,112,CT,196
57,Close A Ramp,Elige,0,0,0,36,1,35,T,196
58,CT Side Apps,Elige,0,0,0,0,66,-66,CT,196
59,CT Side Apps,Elige,1,1,0,68,106,-38,T,196
60,Bench,Elige,3,1,2,167,180,-13,CT,196
61,Bench,Elige,0,0,0,0,0,0,T,196
62,CT Spawn,Elige,0,1,-1,48,100,-52,CT,196
63,CT Spawn,Elige,0,0,0,0,0,0,T,196
64,Underneath B apps plat,Elige,2,1,1,95,100,-5,CT,196
65,Underneath B apps plat,Elige,0,0,0,0,0,0,T,196
66,B Bombsite Cross to Catwalk,Elige,0,0,0,0,0,0,CT,196
67,B Bombsite Cross to Catwalk,Elige,0,1,-1,26,37,-11,T,196
68,CT Catwalk,Elige,1,0,1,65,87,-22,CT,196
69,CT Catwalk,Elige,0,3,-3,39,277,-238,T,196
70,Back Left B Site From T's' Perspective,Elige,3,3,0,269,312,-43,CT,196
71,Back Left B Site From T's' Perspective,Elige,0,0,0,0,0,0,T,196
72,Left Side corner deep jungle,Elige,0,0,0,0,0,0,CT,196
73,Left Side corner deep jungle,Elige,0,0,0,0,0,0,T,196
74,Close Market door,Elige,1,1,0,115,192,-77,CT,196
75,Close Market door,Elige,0,1,-1,11,31,-20,T,196
76,Middle Bench,Elige,0,0,0,0,1,-1,CT,196
77,Middle Bench,Elige,0,3,-3,48,301,-253,T,196
78,Close Left CT A Ramp,Elige,0,0,0,1,0,1,CT,196
79,Close Left CT A Ramp,Elige,0,0,0,0,0,0,T,196
80,Ladder Room Catwalk Side,Elige,2,0,2,216,11,205,CT,196
81,Ladder Room Catwalk Side,Elige,2,2,0,244,275,-31,T,196
82,Jungle Plant,Elige,0,0,0,0,0,0,CT,196
83,Jungle Plant,Elige,0,2,-2,0,153,-153,T,196
84,B site Market Plant,Elige,1,1,0,117,61,56,CT,196
85,B site Market Plant,Elige,0,1,-1,0,75,-75,T,196
86,Back B Site Peeking Apps/Plat,Elige,0,1,-1,0,34,-34,CT,196
87,Back B Site Peeking Apps/Plat,Elige,0,0,0,0,0,0,T,196
88,Murder Hole,Elige,0,1,-1,52,109,-57,CT,196
89,Murder Hole,Elige,0,0,0,0,0,0,T,196
90,Sandwhich,Elige,0,0,0,0,0,0,CT,196
91,Sandwhich,Elige,1,1,0,100,171,-71,T,196
92,Snipers Palace Peek,Elige,0,1,-1,10,191,-181,CT,196
93,Snipers Palace Peek,Elige,1,0,1,100,41,59,T,196
94,Top Mid on top of Boxes,Elige,0,1,-1,0,69,-69,CT,196
95,Top Mid on top of Boxes,Elige,0,0,0,0,0,0,T,196
96,Firebox,Elige,0,2,-2,72,200,-128,CT,196
97,Firebox,Elige,1,0,1,186,59,127,T,196
98,Deep T Apps Underpass STairs,Elige,1,0,1,100,0,100,CT,196
99,Deep T Apps Underpass STairs,Elige,0,0,0,1,1,0,T,196
100,Leftside Connector,Elige,0,1,-1,62,100,-38,CT,196
101,Leftside Connector,Elige,0,0,0,8,13,-5,T,196
102,Arch,Elige,0,1,-1,122,100,22,CT,196
103,Arch,Elige,2,1,1,298,26,272,T,196
104,Balcony Boaxes,Elige,2,1,1,304,100,204,CT,196
105,Balcony Boaxes,Elige,0,0,0,0,0,0,T,196
106,Right Side Platform,Elige,0,0,0,0,0,0,CT,196
107,Right Side Platform,Elige,0,0,0,0,0,0,T,196
108,Elevated Snipers Awp Peek,Elige,0,0,0,54,0,54,CT,196
109,Elevated Snipers Awp Peek,Elige,0,0,0,0,0,0,T,196
110,Under window B apps,Elige,0,0,0,0,0,0,CT,196
111,Under window B apps,Elige,1,1,0,74,73,1,T,196
112,Top Mid Boxes Right Side Peek,Elige,0,0,0,0,0,0,CT,196
113,Top Mid Boxes Right Side Peek,Elige,1,0,1,126,53,73,T,196
114,Bench Closer To Jungle,Elige,1,1,0,193,122,71,CT,196
115,Bench Closer To Jungle,Elige,0,0,0,0,0,0,T,196
116,Inside Market Doors,Elige,1,1,0,157,100,57,CT,196
117,Inside Market Doors,Elige,0,0,0,0,0,0,T,196
118,Close Right Market Window,Elige,0,0,0,0,0,0,CT,196
119,Close Right Market Window,Elige,0,0,0,0,0,0,T,196
120,Under balcony,Elige,0,0,0,0,39,-39,CT,196
121,Under balcony,Elige,0,0,0,0,0,0,T,196
122,Behind Big Boxes,Elige,0,0,0,0,0,0,CT,196
123,Behind Big Boxes,Elige,0,1,-1,0,131,-131,T,196
124,Stairs Palace Peek,Elige,2,0,2,152,63,89,CT,196
125,Stairs Palace Peek,Elige,0,1,-1,0,100,-100,T,196
126,Right Side Snipers Nest,Elige,2,1,1,242,118,124,CT,196
127,Right Side Snipers Nest,Elige,0,0,0,0,0,0,T,196
128,Top STairs,Elige,0,1,-1,0,13,-13,CT,196
129,Top STairs,Elige,0,0,0,0,0,0,T,196
130,Apartments Right CT Corner,Elige,0,0,0,0,0,0,CT,196
131,Apartments Right CT Corner,Elige,0,1,-1,0,34,-34,T,196
132,T Spawn A Ramp,Elige,0,0,0,0,0,0,CT,196
133,T Spawn A Ramp,Elige,1,1,0,108,109,-1,T,196
134,T Deep apps,Elige,1,0,1,100,0,100,CT,196
135,T Deep apps,Elige,0,0,0,0,0,0,T,196
136,Bottom Mid Ladder Room Peek,Elige,0,0,0,0,0,0,CT,196
137,Bottom Mid Ladder Room Peek,Elige,0,0,0,0,19,-19,T,196
138,CT Outside Market,Elige,0,0,0,0,0,0,CT,196
139,CT Outside Market,Elige,0,1,-1,0,78,-78,T,196
140,Catwalk Plant B Site,Elige,1,0,1,100,0,100,CT,196
141,Catwalk Plant B Site,Elige,0,1,-1,35,81,-46,T,196
142,T Deep Apps Underpass/Apps Peek,Elige,0,0,0,0,54,-54,CT,196
143,T Deep Apps Underpass/Apps Peek,Elige,0,0,0,0,65,-65,T,196
144,Top Mid Boxes Left Side Peek,Elige,0,0,0,0,0,0,CT,196
145,Top Mid Boxes Left Side Peek,Elige,3,1,2,431,214,217,T,196
146,Market Window Peek,Elige,0,0,0,70,0,70,CT,196
147,Market Window Peek,Elige,0,0,0,0,0,0,T,196
148,CT Catwalk,Stewie2k,2,3,-1,464,397,67,CT,196
149,CT Catwalk,Stewie2k,2,4,-2,115,400,-285,T,196
150,Ticketbooth ,Stewie2k,0,4,-4,100,350,-250,CT,196
151,Ticketbooth ,Stewie2k,1,2,-1,100,200,-100,T,196
152,Bottom Stairs,Stewie2k,3,1,2,205,114,91,CT,196
153,Bottom Stairs,Stewie2k,1,8,-7,242,711,-469,T,196
154,Deep Catwalk,Stewie2k,3,3,0,329,396,-67,CT,196
155,Deep Catwalk,Stewie2k,1,1,0,73,100,-27,T,196
156,Snipers Nest,Stewie2k,4,2,2,400,183,217,CT,196
157,Snipers Nest,Stewie2k,1,2,-1,100,289,-189,T,196
158,CT Side Apps,Stewie2k,1,1,0,100,100,0,CT,196
159,CT Side Apps,Stewie2k,5,2,3,563,362,201,T,196
160,Catwalk T Aparments Peek,Stewie2k,0,2,-2,0,200,-200,CT,196
161,Catwalk T Aparments Peek,Stewie2k,1,2,-1,154,227,-73,T,196
162,CT Deep Catwalk Mid peek,Stewie2k,7,2,5,768,227,541,CT,196
163,CT Deep Catwalk Mid peek,Stewie2k,0,1,-1,26,100,-74,T,196
164,Back B Site Peeking Apps/Plat,Stewie2k,0,1,-1,21,64,-43,CT,196
165,Back B Site Peeking Apps/Plat,Stewie2k,2,2,0,83,122,-39,T,196
166,Top Mid Left Side,Stewie2k,1,2,-1,100,200,-100,CT,196
167,Top Mid Left Side,Stewie2k,1,2,-1,162,372,-210,T,196
168,Mid Close Connector,Stewie2k,2,1,1,200,3,197,CT,196
169,Mid Close Connector,Stewie2k,2,1,1,244,162,82,T,196
170,Arch,Stewie2k,2,4,-2,364,329,35,CT,196
171,Arch,Stewie2k,0,0,0,44,0,44,T,196
172,Top Mid,Stewie2k,2,0,2,200,0,200,CT,196
173,Top Mid,Stewie2k,1,2,-1,108,222,-114,T,196
174,Default A,Stewie2k,4,1,3,349,106,243,CT,196
175,Default A,Stewie2k,0,1,-1,0,30,-30,T,196
176,Deep T Apps,Stewie2k,0,0,0,0,0,0,CT,196
177,Deep T Apps,Stewie2k,1,1,0,34,223,-189,T,196
178,Catwalk Connector Peek,Stewie2k,3,1,2,482,154,328,CT,196
179,Catwalk Connector Peek,Stewie2k,0,3,-3,23,282,-259,T,196
180,Deep Jungle,Stewie2k,2,1,1,210,141,69,CT,196
181,Deep Jungle,Stewie2k,3,1,2,272,180,92,T,196
182,A Site Exposed to Stairs Connector Cat,Stewie2k,0,1,-1,0,100,-100,CT,196
183,A Site Exposed to Stairs Connector Cat,Stewie2k,1,1,0,24,101,-77,T,196
184,T Palace Stairs Peek,Stewie2k,0,0,0,0,0,0,CT,196
185,T Palace Stairs Peek,Stewie2k,1,2,-1,13,200,-187,T,196
186,Back Right B Site from T's Perspective,Stewie2k,1,2,-1,161,197,-36,CT,196
187,Back Right B Site from T's Perspective,Stewie2k,0,0,0,0,0,0,T,196
188,Leftside Connector,Stewie2k,0,1,-1,54,102,-48,CT,196
189,Leftside Connector,Stewie2k,0,0,0,0,0,0,T,196
190,Bench,Stewie2k,4,3,1,421,356,65,CT,196
191,Bench,Stewie2k,0,1,-1,0,100,-100,T,196
192,A Site,Stewie2k,0,1,-1,35,8,27,CT,196
193,A Site,Stewie2k,0,3,-3,0,240,-240,T,196
194,Right Side Connector,Stewie2k,0,0,0,0,0,0,CT,196
195,Right Side Connector,Stewie2k,2,2,0,251,248,3,T,196
196,Back Left B Site From T's' Perspective,Stewie2k,5,2,3,451,200,251,CT,196
197,Back Left B Site From T's' Perspective,Stewie2k,0,1,-1,0,53,-53,T,196
198,Top Balcony,Stewie2k,1,2,-1,83,200,-117,CT,196
199,Top Balcony,Stewie2k,1,0,1,6,0,6,T,196
200,A Ramp,Stewie2k,0,0,0,0,28,-28,CT,196
201,A Ramp,Stewie2k,0,3,-3,38,282,-244,T,196
202,T Spawn,Stewie2k,0,2,-2,0,192,-192,CT,196
203,T Spawn,Stewie2k,0,0,0,0,0,0,T,196
204,T Spawn A Ramp,Stewie2k,0,0,0,0,0,0,CT,196
205,T Spawn A Ramp,Stewie2k,2,3,-1,200,280,-80,T,196
206,Top Mid towards Apps,Stewie2k,0,0,0,0,0,0,CT,196
207,Top Mid towards Apps,Stewie2k,0,1,-1,69,100,-31,T,196
208,Triple Box,Stewie2k,1,2,-1,201,178,23,CT,196
209,Triple Box,Stewie2k,2,0,2,168,0,168,T,196
210,Deep Palace,Stewie2k,1,1,0,100,122,-22,CT,196
211,Deep Palace,Stewie2k,0,1,-1,0,100,-100,T,196
212,Underpass,Stewie2k,0,1,-1,0,102,-102,CT,196
213,Underpass,Stewie2k,3,1,2,274,249,25,T,196
214,Semi Elevated CT Van,Stewie2k,1,1,0,44,31,13,CT,196
215,Semi Elevated CT Van,Stewie2k,0,0,0,0,0,0,T,196
216,B Bombsite Cross to Catwalk,Stewie2k,5,0,5,476,68,408,CT,196
217,B Bombsite Cross to Catwalk,Stewie2k,3,0,3,117,26,91,T,196
218,Right Side Snipers Nest,Stewie2k,0,1,-1,0,100,-100,CT,196
219,Right Side Snipers Nest,Stewie2k,0,0,0,0,0,0,T,196
220,market,Stewie2k,0,0,0,0,0,0,CT,196
221,market,Stewie2k,2,2,0,251,166,85,T,196
222,Close Market door,Stewie2k,0,2,-2,0,202,-202,CT,196
223,Close Market door,Stewie2k,0,0,0,0,0,0,T,196
224,Market Window Peek,Stewie2k,0,0,0,0,0,0,CT,196
225,Market Window Peek,Stewie2k,0,0,0,0,0,0,T,196
226,Underneath B apps plat,Stewie2k,0,1,-1,0,194,-194,CT,196
227,Underneath B apps plat,Stewie2k,0,1,-1,26,1,25,T,196
228,CT Spawn,Stewie2k,0,0,0,0,0,0,CT,196
229,CT Spawn,Stewie2k,0,0,0,0,0,0,T,196
230,Left Side Platform,Stewie2k,4,1,3,573,100,473,CT,196
231,Left Side Platform,Stewie2k,1,1,0,100,176,-76,T,196
232,Top Mid Boxes Right Side Peek,Stewie2k,0,0,0,0,0,0,CT,196
233,Top Mid Boxes Right Side Peek,Stewie2k,1,1,0,75,96,-21,T,196
234,Top Mid Catwalk,Stewie2k,0,0,0,0,0,0,CT,196
235,Top Mid Catwalk,Stewie2k,1,1,0,100,122,-22,T,196
236,Under window B apps,Stewie2k,1,1,0,86,100,-14,CT,196
237,Under window B apps,Stewie2k,0,1,-1,0,6,-6,T,196
238,Bottom Connector,Stewie2k,1,0,1,100,33,67,CT,196
239,Bottom Connector,Stewie2k,4,0,4,296,40,256,T,196
240,Stairs Palace Peek,Stewie2k,2,2,0,130,188,-58,CT,196
241,Stairs Palace Peek,Stewie2k,0,0,0,0,0,0,T,196
242,Inside Market Doors,Stewie2k,0,0,0,0,0,0,CT,196
243,Inside Market Doors,Stewie2k,0,1,-1,27,57,-30,T,196
244,B Site Default Plant,Stewie2k,0,0,0,0,0,0,CT,196
245,B Site Default Plant,Stewie2k,0,0,0,0,0,0,T,196
246,Jungle Plant,Stewie2k,0,1,-1,24,83,-59,CT,196
247,Jungle Plant,Stewie2k,0,1,-1,30,63,-33,T,196
248,Left Side corner deep jungle,Stewie2k,0,1,-1,0,100,-100,CT,196
249,Left Side corner deep jungle,Stewie2k,0,0,0,0,0,0,T,196
250,Tetris,Stewie2k,0,1,-1,32,100,-68,CT,196
251,Tetris,Stewie2k,0,0,0,0,0,0,T,196
252,CT Outside Market,Stewie2k,0,0,0,0,27,-27,CT,196
253,CT Outside Market,Stewie2k,2,2,0,200,125,75,T,196
254,Ladder Room Catwalk Side,Stewie2k,2,1,1,295,182,113,CT,196
255,Ladder Room Catwalk Side,Stewie2k,1,0,1,100,0,100,T,196
256,Top Van,Stewie2k,1,0,1,68,16,52,CT,196
257,Top Van,Stewie2k,0,0,0,0,0,0,T,196
258,Snipers Palace Peek,Stewie2k,3,0,3,85,16,69,CT,196
259,Snipers Palace Peek,Stewie2k,0,0,0,0,0,0,T,196
260,Forest,Stewie2k,0,0,0,36,20,16,CT,196
261,Forest,Stewie2k,1,0,1,23,11,12,T,196
262,Bench Closer To Jungle,Stewie2k,1,0,1,9,0,9,CT,196
263,Bench Closer To Jungle,Stewie2k,0,1,-1,0,76,-76,T,196
264,Catwalk Plant B Site,Stewie2k,0,0,0,33,0,33,CT,196
265,Catwalk Plant B Site,Stewie2k,0,0,0,0,0,0,T,196
266,Firebox,Stewie2k,0,0,0,0,8,-8,CT,196
267,Firebox,Stewie2k,0,0,0,0,70,-70,T,196
268,Bottom Mid Ladder Room Peek,Stewie2k,0,0,0,0,0,0,CT,196
269,Bottom Mid Ladder Room Peek,Stewie2k,1,1,0,50,101,-51,T,196
270,Safe Plant B Site,Stewie2k,0,1,-1,0,98,-98,CT,196
271,Safe Plant B Site,Stewie2k,0,0,0,0,0,0,T,196
272,Top Connector,Stewie2k,0,0,0,1,0,1,CT,196
273,Top Connector,Stewie2k,0,0,0,0,0,0,T,196
274,Bench Closer to Tribox,Stewie2k,0,0,0,0,0,0,CT,196
275,Bench Closer to Tribox,Stewie2k,0,0,0,22,0,22,T,196
276,Apartments Right CT Corner,Stewie2k,0,0,0,0,0,0,CT,196
277,Apartments Right CT Corner,Stewie2k,0,0,0,0,22,-22,T,196
278,Behind Big Boxes,Stewie2k,0,0,0,0,0,0,CT,196
279,Behind Big Boxes,Stewie2k,1,0,1,74,0,74,T,196
280,Right Side Platform,Stewie2k,0,0,0,0,0,0,CT,196
281,Right Side Platform,Stewie2k,0,0,0,0,0,0,T,196
282,Van Barrel Peek,Stewie2k,0,0,0,0,58,-58,CT,196
283,Van Barrel Peek,Stewie2k,0,1,-1,0,100,-100,T,196
284,Close Right Market Window,Stewie2k,0,0,0,0,0,0,CT,196
285,Close Right Market Window,Stewie2k,1,1,0,75,75,0,T,196
286,Top Mid Boxes Left Side Peek,Stewie2k,0,0,0,0,0,0,CT,196
287,Top Mid Boxes Left Side Peek,Stewie2k,0,0,0,0,4,-4,T,196
288,Deep CT,Stewie2k,0,0,0,10,0,10,CT,196
289,Deep CT,Stewie2k,0,0,0,0,0,0,T,196
290,Sandwhich,Stewie2k,0,0,0,0,92,-92,CT,196
291,Sandwhich,Stewie2k,0,0,0,0,0,0,T,196
292,B site Market Plant,Stewie2k,0,1,-1,23,100,-77,CT,196
293,B site Market Plant,Stewie2k,0,0,0,0,0,0,T,196
294,Register Market,Stewie2k,0,0,0,0,0,0,CT,196
295,Register Market,Stewie2k,1,0,1,13,0,13,T,196
296,Chair,Stewie2k,0,0,0,22,0,22,CT,196
297,Chair,Stewie2k,2,0,2,237,67,170,T,196
298,Close Left CT A Ramp,Stewie2k,0,0,0,0,0,0,CT,196
299,Close Left CT A Ramp,Stewie2k,1,0,1,27,0,27,T,196
300,Top STairs,Stewie2k,0,0,0,0,0,0,CT,196
301,Top STairs,Stewie2k,0,0,0,0,0,0,T,196
302,Default A,Naf-fly,0,4,-4,66,377,-311,CT,196
303,Default A,Naf-fly,4,6,-2,487,568,-81,T,196
304,CT Side Apps,Naf-fly,0,1,-1,0,152,-152,CT,196
305,CT Side Apps,Naf-fly,5,3,2,403,390,13,T,196
306,Ticketbooth ,Naf-fly,10,7,3,1000,685,315,CT,196
307,Ticketbooth ,Naf-fly,3,2,1,327,200,127,T,196
308,T Palace Stairs Peek,Naf-fly,2,1,1,256,100,156,CT,196
309,T Palace Stairs Peek,Naf-fly,4,5,-1,592,659,-67,T,196
310,Top Balcony,Naf-fly,0,0,0,0,0,0,CT,196
311,Top Balcony,Naf-fly,5,7,-2,695,652,43,T,196
312,A Site,Naf-fly,0,1,-1,0,73,-73,CT,196
313,A Site,Naf-fly,0,5,-5,123,491,-368,T,196
314,CT Catwalk,Naf-fly,5,1,4,480,155,325,CT,196
315,CT Catwalk,Naf-fly,0,1,-1,0,100,-100,T,196
316,Left Side Platform,Naf-fly,0,2,-2,124,114,10,CT,196
317,Left Side Platform,Naf-fly,4,4,0,445,509,-64,T,196
318,A Ramp,Naf-fly,1,0,1,68,0,68,CT,196
319,A Ramp,Naf-fly,4,2,2,495,294,201,T,196
320,A Site Exposed to Stairs Connector Cat,Naf-fly,1,2,-1,52,175,-123,CT,196
321,A Site Exposed to Stairs Connector Cat,Naf-fly,0,0,0,22,0,22,T,196
322,B Bombsite Cross to Catwalk,Naf-fly,0,1,-1,33,74,-41,CT,196
323,B Bombsite Cross to Catwalk,Naf-fly,1,1,0,114,130,-16,T,196
324,Snipers Nest,Naf-fly,1,3,-2,225,286,-61,CT,196
325,Snipers Nest,Naf-fly,0,0,0,0,0,0,T,196
326,market,Naf-fly,0,2,-2,134,213,-79,CT,196
327,market,Naf-fly,0,0,0,0,0,0,T,196
328,Close Market door,Naf-fly,3,1,2,315,110,205,CT,196
329,Close Market door,Naf-fly,0,0,0,0,0,0,T,196
330,Close Left CT A Ramp,Naf-fly,0,0,0,0,0,0,CT,196
331,Close Left CT A Ramp,Naf-fly,1,1,0,74,80,-6,T,196
332,Deep CT,Naf-fly,1,1,0,114,49,65,CT,196
333,Deep CT,Naf-fly,1,0,1,66,38,28,T,196
334,Underneath B apps plat,Naf-fly,5,2,3,467,216,251,CT,196
335,Underneath B apps plat,Naf-fly,0,0,0,0,0,0,T,196
336,Top Mid Left Side,Naf-fly,1,1,0,100,100,0,CT,196
337,Top Mid Left Side,Naf-fly,1,0,1,100,33,67,T,196
338,Sandwhich,Naf-fly,2,1,1,233,127,106,CT,196
339,Sandwhich,Naf-fly,0,0,0,0,22,-22,T,196
340,Bottom Stairs,Naf-fly,1,3,-2,100,246,-146,CT,196
341,Bottom Stairs,Naf-fly,0,1,-1,0,100,-100,T,196
342,Mid Close Connector,Naf-fly,0,1,-1,99,178,-79,CT,196
343,Mid Close Connector,Naf-fly,0,2,-2,28,141,-113,T,196
344,Arch,Naf-fly,0,2,-2,26,119,-93,CT,196
345,Arch,Naf-fly,0,1,-1,0,100,-100,T,196
346,Market Window Peek,Naf-fly,2,1,1,245,184,61,CT,196
347,Market Window Peek,Naf-fly,0,1,-1,0,100,-100,T,196
348,Catwalk Plant B Site,Naf-fly,0,0,0,0,0,0,CT,196
349,Catwalk Plant B Site,Naf-fly,0,1,-1,52,4,48,T,196
350,Catwalk Connector Peek,Naf-fly,0,0,0,0,0,0,CT,196
351,Catwalk Connector Peek,Naf-fly,0,2,-2,52,200,-148,T,196
352,Top Mid towards Apps,Naf-fly,0,2,-2,27,134,-107,CT,196
353,Top Mid towards Apps,Naf-fly,1,0,1,100,0,100,T,196
354,Underpass,Naf-fly,1,2,-1,19,196,-177,CT,196
355,Underpass,Naf-fly,0,0,0,27,67,-40,T,196
356,CT Deep Catwalk Mid peek,Naf-fly,2,0,2,106,105,1,CT,196
357,CT Deep Catwalk Mid peek,Naf-fly,0,0,0,0,0,0,T,196
358,Deep Palace,Naf-fly,0,0,0,0,0,0,CT,196
359,Deep Palace,Naf-fly,5,0,5,656,232,424,T,196
360,Deep Catwalk,Naf-fly,1,1,0,100,100,0,CT,196
361,Deep Catwalk,Naf-fly,2,1,1,170,103,67,T,196
362,Jungle Plant,Naf-fly,0,0,0,0,0,0,CT,196
363,Jungle Plant,Naf-fly,0,2,-2,41,246,-205,T,196
364,Stairs Palace Peek,Naf-fly,1,1,0,117,73,44,CT,196
365,Stairs Palace Peek,Naf-fly,1,0,1,100,0,100,T,196
366,Close Right Market Window,Naf-fly,0,0,0,0,0,0,CT,196
367,Close Right Market Window,Naf-fly,1,0,1,86,0,86,T,196
368,B site Market Plant,Naf-fly,1,2,-1,79,114,-35,CT,196
369,B site Market Plant,Naf-fly,1,0,1,15,0,15,T,196
370,Catwalk T Aparments Peek,Naf-fly,1,2,-1,9,200,-191,CT,196
371,Catwalk T Aparments Peek,Naf-fly,0,0,0,5,54,-49,T,196
372,Bench,Naf-fly,5,1,4,319,193,126,CT,196
373,Bench,Naf-fly,0,1,-1,0,100,-100,T,196
374,Back Right B Site from T's Perspective,Naf-fly,1,1,0,72,48,24,CT,196
375,Back Right B Site from T's Perspective,Naf-fly,0,1,-1,0,100,-100,T,196
376,T Spawn A Ramp,Naf-fly,0,0,0,0,0,0,CT,196
377,T Spawn A Ramp,Naf-fly,2,1,1,364,189,175,T,196
378,Back B Site Peeking Apps/Plat,Naf-fly,2,1,1,155,100,55,CT,196
379,Back B Site Peeking Apps/Plat,Naf-fly,1,1,0,71,77,-6,T,196
380,Top Mid,Naf-fly,0,0,0,0,0,0,CT,196
381,Top Mid,Naf-fly,1,0,1,44,0,44,T,196
382,Deep Jungle,Naf-fly,1,1,0,148,154,-6,CT,196
383,Deep Jungle,Naf-fly,0,0,0,0,0,0,T,196
384,T Deep Apps Underpass/Apps Peek,Naf-fly,1,1,0,100,100,0,CT,196
385,T Deep Apps Underpass/Apps Peek,Naf-fly,0,0,0,0,0,0,T,196
386,Ninja,Naf-fly,0,1,-1,68,100,-32,CT,196
387,Ninja,Naf-fly,0,0,0,0,0,0,T,196
388,Triple Box,Naf-fly,2,0,2,84,113,-29,CT,196
389,Triple Box,Naf-fly,0,0,0,0,4,-4,T,196
390,Forest,Naf-fly,0,0,0,0,0,0,CT,196
391,Forest,Naf-fly,0,0,0,0,0,0,T,196
392,Middle Bench,Naf-fly,0,1,-1,0,100,-100,CT,196
393,Middle Bench,Naf-fly,0,0,0,84,0,84,T,196
394,Right Side Platform,Naf-fly,0,0,0,46,34,12,CT,196
395,Right Side Platform,Naf-fly,1,1,0,66,100,-34,T,196
396,Right Side Connector,Naf-fly,1,0,1,100,3,97,CT,196
397,Right Side Connector,Naf-fly,0,0,0,0,0,0,T,196
398,CT Spawn,Naf-fly,0,0,0,0,0,0,CT,196
399,CT Spawn,Naf-fly,0,0,0,0,0,0,T,196
400,T Spawn towards Apps,Naf-fly,1,0,1,134,66,68,CT,196
401,T Spawn towards Apps,Naf-fly,0,0,0,0,0,0,T,196
402,Top Van,Naf-fly,0,0,0,0,0,0,CT,196
403,Top Van,Naf-fly,0,0,0,0,0,0,T,196
404,Semi Elevated CT Van,Naf-fly,1,1,0,100,100,0,CT,196
405,Semi Elevated CT Van,Naf-fly,0,0,0,0,0,0,T,196
406,Top Connector,Naf-fly,0,0,0,0,0,0,CT,196
407,Top Connector,Naf-fly,0,0,0,0,0,0,T,196
408,Close Market Window,Naf-fly,0,0,0,0,0,0,CT,196
409,Close Market Window,Naf-fly,0,0,0,0,0,0,T,196
410,Top Mid Catwalk,Naf-fly,0,0,0,0,0,0,CT,196
411,Top Mid Catwalk,Naf-fly,0,0,0,0,0,0,T,196
412,Leftside Connector,Naf-fly,1,0,1,183,0,183,CT,196
413,Leftside Connector,Naf-fly,0,0,0,0,0,0,T,196
414,Flowerpot CT,Naf-fly,0,1,-1,0,66,-66,CT,196
415,Flowerpot CT,Naf-fly,0,0,0,0,0,0,T,196
416,Under window B apps,Naf-fly,0,0,0,0,0,0,CT,196
417,Under window B apps,Naf-fly,0,0,0,0,0,0,T,196
418,B Site Default Plant,Naf-fly,0,0,0,0,34,-34,CT,196
419,B Site Default Plant,Naf-fly,0,0,0,0,27,-27,T,196
420,CT Outside Market,Naf-fly,1,1,0,134,208,-74,CT,196
421,CT Outside Market,Naf-fly,0,0,0,0,0,0,T,196
422,Balcony Boaxes,Naf-fly,0,0,0,0,0,0,CT,196
423,Balcony Boaxes,Naf-fly,0,0,0,0,0,0,T,196
424,Register Market,Naf-fly,0,0,0,0,0,0,CT,196
425,Register Market,Naf-fly,0,1,-1,0,100,-100,T,196
426,Back,Naf-fly,0,1,-1,0,100,-100,CT,196
427,Back,Naf-fly,0,0,0,0,0,0,T,196
428,Deep T Apps,Naf-fly,0,0,0,0,0,0,CT,196
429,Deep T Apps,Naf-fly,0,0,0,104,23,81,T,196
430,Apartments Right CT Corner,Naf-fly,0,0,0,0,0,0,CT,196
431,Apartments Right CT Corner,Naf-fly,1,0,1,100,0,100,T,196
432,Tetris,Naf-fly,0,0,0,0,0,0,CT,196
433,Tetris,Naf-fly,0,0,0,0,0,0,T,196
434,Connector behind box,Naf-fly,1,0,1,48,0,48,CT,196
435,Connector behind box,Naf-fly,0,0,0,0,9,-9,T,196
436,A Ramp,Grim,7,6,1,794,610,184,CT,196
437,A Ramp,Grim,2,7,-5,342,838,-496,T,196
438,CT Side Apps,Grim,1,1,0,100,100,0,CT,196
439,CT Side Apps,Grim,0,3,-3,174,486,-312,T,196
440,Top Balcony,Grim,2,4,-2,222,360,-138,CT,196
441,Top Balcony,Grim,0,0,0,0,0,0,T,196
442,Default A,Grim,4,7,-3,493,596,-103,CT,196
443,Default A,Grim,3,2,1,312,173,139,T,196
444,A Site Exposed to Stairs Connector Cat,Grim,1,1,0,69,47,22,CT,196
445,A Site Exposed to Stairs Connector Cat,Grim,0,4,-4,15,408,-393,T,196
446,Triple Box,Grim,5,2,3,395,199,196,CT,196
447,Triple Box,Grim,1,1,0,70,5,65,T,196
448,Close A Ramp,Grim,2,2,0,207,203,4,CT,196
449,Close A Ramp,Grim,1,1,0,139,159,-20,T,196
450,Underneath B apps plat,Grim,4,5,-1,601,466,135,CT,196
451,Underneath B apps plat,Grim,0,0,0,8,8,0,T,196
452,Deep T Apps,Grim,0,1,-1,28,100,-72,CT,196
453,Deep T Apps,Grim,0,4,-4,174,429,-255,T,196
454,Sandwhich,Grim,0,1,-1,0,66,-66,CT,196
455,Sandwhich,Grim,2,2,0,227,159,68,T,196
456,CT Deep Catwalk Mid peek,Grim,3,2,1,170,161,9,CT,196
457,CT Deep Catwalk Mid peek,Grim,0,1,-1,0,100,-100,T,196
458,B Site Default Plant,Grim,0,3,-3,128,306,-178,CT,196
459,B Site Default Plant,Grim,1,2,-1,163,200,-37,T,196
460,Ticketbooth ,Grim,3,2,1,384,291,93,CT,196
461,Ticketbooth ,Grim,1,1,0,210,164,46,T,196
462,Mid Close Connector,Grim,0,1,-1,0,73,-73,CT,196
463,Mid Close Connector,Grim,0,2,-2,40,169,-129,T,196
464,Deep CT,Grim,2,1,1,217,111,106,CT,196
465,Deep CT,Grim,0,3,-3,72,284,-212,T,196
466,Deep Palace,Grim,4,2,2,328,227,101,CT,196
467,Deep Palace,Grim,0,1,-1,0,100,-100,T,196
468,Bottom Stairs,Grim,1,0,1,76,0,76,CT,196
469,Bottom Stairs,Grim,2,3,-1,166,318,-152,T,196
470,Close Market door,Grim,0,2,-2,100,173,-73,CT,196
471,Close Market door,Grim,0,0,0,0,0,0,T,196
472,A Site,Grim,2,1,1,262,96,166,CT,196
473,A Site,Grim,1,3,-2,234,294,-60,T,196
474,Left Side Platform,Grim,1,0,1,114,27,87,CT,196
475,Left Side Platform,Grim,5,2,3,722,294,428,T,196
476,CT Catwalk,Grim,1,1,0,171,139,32,CT,196
477,CT Catwalk,Grim,0,2,-2,0,197,-197,T,196
478,Arch,Grim,1,2,-1,128,200,-72,CT,196
479,Arch,Grim,0,0,0,0,0,0,T,196
480,Back B Site Peeking Apps/Plat,Grim,1,1,0,126,122,4,CT,196
481,Back B Site Peeking Apps/Plat,Grim,2,1,1,162,112,50,T,196
482,T Spawn A Ramp,Grim,0,0,0,0,0,0,CT,196
483,T Spawn A Ramp,Grim,5,1,4,395,197,198,T,196
484,Bench,Grim,4,1,3,326,128,198,CT,196
485,Bench,Grim,0,2,-2,0,85,-85,T,196
486,Deep Jungle,Grim,0,0,0,0,0,0,CT,196
487,Deep Jungle,Grim,1,1,0,154,70,84,T,196
488,CT Left Side,Grim,1,2,-1,162,253,-91,CT,196
489,CT Left Side,Grim,2,0,2,117,0,117,T,196
490,Deep Catwalk,Grim,0,0,0,0,0,0,CT,196
491,Deep Catwalk,Grim,0,0,0,81,0,81,T,196
492,Catwalk T Aparments Peek,Grim,1,0,1,38,0,38,CT,196
493,Catwalk T Aparments Peek,Grim,1,1,0,74,100,-26,T,196
494,B site Market Plant,Grim,0,1,-1,0,100,-100,CT,196
495,B site Market Plant,Grim,2,1,1,221,25,196,T,196
496,Apartments Right CT Corner,Grim,0,1,-1,89,100,-11,CT,196
497,Apartments Right CT Corner,Grim,0,1,-1,4,100,-96,T,196
498,Underpass,Grim,1,1,0,100,127,-27,CT,196
499,Underpass,Grim,3,1,2,346,320,26,T,196
500,Tetris,Grim,0,1,-1,0,100,-100,CT,196
501,Tetris,Grim,1,0,1,11,0,11,T,196
502,Deep T Spawn T Ramp,Grim,0,0,0,0,0,0,CT,196
503,Deep T Spawn T Ramp,Grim,0,0,0,0,0,0,T,196
504,Back Right B Site from T's Perspective,Grim,0,1,-1,0,100,-100,CT,196
505,Back Right B Site from T's Perspective,Grim,0,0,0,0,0,0,T,196
506,Deep T Apps Underpass STairs,Grim,0,0,0,0,0,0,CT,196
507,Deep T Apps Underpass STairs,Grim,3,1,2,235,100,135,T,196
508,Catwalk Plant B Site,Grim,1,0,1,40,0,40,CT,196
509,Catwalk Plant B Site,Grim,1,2,-1,227,327,-100,T,196
510,Snipers Palace Peek,Grim,0,1,-1,0,100,-100,CT,196
511,Snipers Palace Peek,Grim,0,0,0,0,0,0,T,196
512,Top Connector,Grim,0,1,-1,0,100,-100,CT,196
513,Top Connector,Grim,1,1,0,100,149,-49,T,196
514,Bottom Connector,Grim,0,0,0,0,0,0,CT,196
515,Bottom Connector,Grim,0,1,-1,37,94,-57,T,196
516,Close Left CT A Ramp,Grim,0,1,-1,44,100,-56,CT,196
517,Close Left CT A Ramp,Grim,2,0,2,169,17,152,T,196
518,Snipers Nest,Grim,0,1,-1,0,100,-100,CT,196
519,Snipers Nest,Grim,0,0,0,0,0,0,T,196
520,Leftside Connector,Grim,0,0,0,0,0,0,CT,196
521,Leftside Connector,Grim,1,0,1,100,0,100,T,196
522,T Palace Stairs Peek,Grim,0,1,-1,68,100,-32,CT,196
523,T Palace Stairs Peek,Grim,0,0,0,0,0,0,T,196
524,Market Window Peek,Grim,0,1,-1,0,100,-100,CT,196
525,Market Window Peek,Grim,0,0,0,0,0,0,T,196
526,Ladder Room Catwalk Side,Grim,0,0,0,0,0,0,CT,196
527,Ladder Room Catwalk Side,Grim,0,0,0,0,0,0,T,196
528,Catwalk Connector Peek,Grim,0,0,0,0,0,0,CT,196
529,Catwalk Connector Peek,Grim,1,1,0,19,100,-81,T,196
530,Bottom Mid Ladder Room Peek,Grim,0,0,0,0,0,0,CT,196
531,Bottom Mid Ladder Room Peek,Grim,0,1,-1,0,131,-131,T,196
532,Firebox,Grim,1,0,1,100,0,100,CT,196
533,Firebox,Grim,2,0,2,200,24,176,T,196
534,Forest,Grim,0,1,-1,28,68,-40,CT,196
535,Forest,Grim,0,0,0,0,8,-8,T,196
536,Middle Bench,Grim,0,0,0,0,0,0,CT,196
537,Middle Bench,Grim,0,1,-1,16,100,-84,T,196
538,Semi Elevated CT Van,Grim,1,1,0,20,100,-80,CT,196
539,Semi Elevated CT Van,Grim,0,0,0,0,0,0,T,196
540,Bench Closer to Tribox,Grim,0,0,0,100,27,73,CT,196
541,Bench Closer to Tribox,Grim,0,0,0,0,0,0,T,196
542,Top Mid,Grim,0,0,0,0,0,0,CT,196
543,Top Mid,Grim,1,0,1,77,81,-4,T,196
544,T Spawn,Grim,2,0,2,200,0,200,CT,196
545,T Spawn,Grim,0,0,0,0,0,0,T,196
546,market,Grim,0,0,0,14,0,14,CT,196
547,market,Grim,0,0,0,0,0,0,T,196
548,Top Mid Left Side,Grim,0,0,0,0,0,0,CT,196
549,Top Mid Left Side,Grim,0,1,-1,97,103,-6,T,196
550,Attic,Grim,0,0,0,0,0,0,CT,196
551,Attic,Grim,0,1,-1,0,7,-7,T,196
552,B Bombsite Cross to Catwalk,Grim,1,0,1,109,35,74,CT,196
553,B Bombsite Cross to Catwalk,Grim,0,1,-1,0,16,-16,T,196
554,CT Outside Market,Grim,0,0,0,1,22,-21,CT,196
555,CT Outside Market,Grim,0,0,0,0,0,0,T,196
556,Bench Closer To Jungle,Grim,0,0,0,0,0,0,CT,196
557,Bench Closer To Jungle,Grim,0,0,0,0,0,0,T,196
558,Balcony Boaxes,Grim,0,1,-1,0,100,-100,CT,196
559,Balcony Boaxes,Grim,0,0,0,7,0,7,T,196
560,Ninja,Grim,0,0,0,0,0,0,CT,196
561,Ninja,Grim,0,0,0,0,0,0,T,196
562,Van Barrel Peek,Grim,1,0,1,78,0,78,CT,196
563,Van Barrel Peek,Grim,0,1,-1,0,10,-10,T,196
564,A Site,Fallen,0,0,0,0,0,0,CT,106
565,A Site,Fallen,2,1,1,257,191,66,T,106
566,A Ramp,Fallen,0,1,-1,89,100,-11,CT,106
567,A Ramp,Fallen,4,3,1,469,380,89,T,106
568,Ticketbooth ,Fallen,5,4,1,717,437,280,CT,106
569,Ticketbooth ,Fallen,0,0,0,83,0,83,T,106
570,CT Side Apps,Fallen,1,0,1,100,0,100,CT,106
571,CT Side Apps,Fallen,0,4,-4,0,257,-257,T,106
572,Deep Catwalk,Fallen,0,2,-2,0,186,-186,CT,106
573,Deep Catwalk,Fallen,0,2,-2,1,106,-105,T,106
574,Underpass,Fallen,1,2,-1,173,127,46,CT,106
575,Underpass,Fallen,1,0,1,87,93,-6,T,106
576,Mid Close Connector,Fallen,1,1,0,46,116,-70,CT,106
577,Mid Close Connector,Fallen,2,1,1,156,100,56,T,106
578,Top Mid Left Side,Fallen,1,0,1,25,0,25,CT,106
579,Top Mid Left Side,Fallen,2,0,2,282,38,244,T,106
580,Top Mid,Fallen,0,1,-1,0,100,-100,CT,106
581,Top Mid,Fallen,1,3,-2,111,127,-16,T,106
582,Close Left CT A Ramp,Fallen,1,2,-1,100,158,-58,CT,106
583,Close Left CT A Ramp,Fallen,0,0,0,0,0,0,T,106
584,Top Connector,Fallen,0,0,0,0,0,0,CT,106
585,Top Connector,Fallen,0,1,-1,0,100,-100,T,106
586,Bottom Stairs,Fallen,2,1,1,165,101,64,CT,106
587,Bottom Stairs,Fallen,1,1,0,100,186,-86,T,106
588,A Site Exposed to Stairs Connector Cat,Fallen,0,1,-1,0,139,-139,CT,106
589,A Site Exposed to Stairs Connector Cat,Fallen,1,1,0,76,14,62,T,106
590,Top Balcony,Fallen,0,1,-1,106,100,6,CT,106
591,Top Balcony,Fallen,0,0,0,0,0,0,T,106
592,Back B Site Peeking Apps/Plat,Fallen,0,0,0,5,0,5,CT,106
593,Back B Site Peeking Apps/Plat,Fallen,0,0,0,43,0,43,T,106
594,T Spawn A Ramp,Fallen,0,0,0,0,0,0,CT,106
595,T Spawn A Ramp,Fallen,0,1,-1,0,167,-167,T,106
596,Deep CT,Fallen,1,1,0,100,100,0,CT,106
597,Deep CT,Fallen,0,0,0,0,0,0,T,106
598,B Bombsite Cross to Catwalk,Fallen,1,1,0,9,39,-30,CT,106
599,B Bombsite Cross to Catwalk,Fallen,0,1,-1,0,100,-100,T,106
600,Market Window Peek,Fallen,0,1,-1,6,86,-80,CT,106
601,Market Window Peek,Fallen,0,0,0,0,0,0,T,106
602,Apartments Right CT Corner,Fallen,0,0,0,0,0,0,CT,106
603,Apartments Right CT Corner,Fallen,0,2,-2,27,276,-249,T,106
604,T Palace Stairs Peek,Fallen,1,0,1,100,34,66,CT,106
605,T Palace Stairs Peek,Fallen,0,1,-1,0,100,-100,T,106
606,Bottom Connector,Fallen,1,0,1,100,0,100,CT,106
607,Bottom Connector,Fallen,1,1,0,96,98,-2,T,106
608,Deep T Apps,Fallen,0,0,0,0,0,0,CT,106
609,Deep T Apps,Fallen,0,1,-1,0,154,-154,T,106
610,Jungle Plant,Fallen,1,0,1,11,0,11,CT,106
611,Jungle Plant,Fallen,0,1,-1,0,100,-100,T,106
612,Ninja,Fallen,0,1,-1,0,100,-100,CT,106
613,Ninja,Fallen,1,0,1,100,0,100,T,106
614,Deep Palace,Fallen,0,1,-1,0,100,-100,CT,106
615,Deep Palace,Fallen,0,0,0,0,0,0,T,106
616,market,Fallen,1,1,0,97,41,56,CT,106
617,market,Fallen,1,0,1,100,0,100,T,106
618,Deep Jungle,Fallen,1,0,1,89,0,89,CT,106
619,Deep Jungle,Fallen,1,0,1,15,0,15,T,106
620,CT Left Side,Fallen,0,2,-2,86,197,-111,CT,106
621,CT Left Side,Fallen,1,0,1,47,52,-5,T,106
622,Default A,Fallen,1,0,1,100,30,70,CT,106
623,Default A,Fallen,1,0,1,11,35,-24,T,106
624,Left Side Platform,Fallen,0,0,0,0,10,-10,CT,106
625,Left Side Platform,Fallen,0,0,0,57,0,57,T,106
626,Forest,Fallen,0,0,0,0,0,0,CT,106
627,Forest,Fallen,0,0,0,13,0,13,T,106
628,Close A Ramp,Fallen,1,1,0,138,116,22,CT,106
629,Close A Ramp,Fallen,1,0,1,100,0,100,T,106
630,Deep T Apps Underpass STairs,Fallen,0,0,0,0,0,0,CT,106
631,Deep T Apps Underpass STairs,Fallen,0,0,0,0,0,0,T,106
632,Top Mid towards Apps,Fallen,0,0,0,0,0,0,CT,106
633,Top Mid towards Apps,Fallen,0,0,0,1,2,-1,T,106
634,Behind Big Boxes,Fallen,0,0,0,0,0,0,CT,106
635,Behind Big Boxes,Fallen,0,0,0,36,1,35,T,106
636,Catwalk T Aparments Peek,Fallen,0,0,0,0,13,-13,CT,106
637,Catwalk T Aparments Peek,Fallen,0,0,0,0,29,-29,T,106
638,Top Mid Boxes Right Side Peek,Fallen,0,0,0,0,0,0,CT,106
639,Top Mid Boxes Right Side Peek,Fallen,0,0,0,0,0,0,T,106
640,Tetris,Fallen,0,0,0,0,0,0,CT,106
641,Tetris,Fallen,0,0,0,25,0,25,T,106
642,Top Mid Catwalk,Fallen,0,0,0,0,0,0,CT,106
643,Top Mid Catwalk,Fallen,0,0,0,0,0,0,T,106
644,Connector behind box,Fallen,0,1,-1,67,100,-33,CT,106
645,Connector behind box,Fallen,0,0,0,0,0,0,T,106
646,Firebox,Fallen,0,0,0,0,0,0,CT,106
647,Firebox,Fallen,1,0,1,74,0,74,T,106
648,Snipers Palace Peek,Fallen,2,1,1,343,102,241,CT,106
649,Snipers Palace Peek,Fallen,1,0,1,100,0,100,T,106
650,Underneath B apps plat,Fallen,1,0,1,50,0,50,CT,106
651,Underneath B apps plat,Fallen,0,0,0,0,0,0,T,106
652,Snipers Nest,Fallen,5,1,4,492,180,312,CT,106
653,Snipers Nest,Fallen,0,0,0,0,0,0,T,106
654,Bench Closer To Jungle,Fallen,0,0,0,0,0,0,CT,106
655,Bench Closer To Jungle,Fallen,0,1,-1,81,100,-19,T,106
656,Back Right B Site from T's Perspective,Fallen,1,0,1,100,0,100,CT,106
657,Back Right B Site from T's Perspective,Fallen,0,1,-1,51,72,-21,T,106
658,Close Market door,Fallen,2,1,1,152,127,25,CT,106
659,Close Market door,Fallen,0,0,0,66,0,66,T,106
660,Leftside Connector,Fallen,0,0,0,0,0,0,CT,106
661,Leftside Connector,Fallen,0,0,0,89,0,89,T,106
662,Left Side corner deep jungle,Fallen,0,0,0,0,0,0,CT,106
663,Left Side corner deep jungle,Fallen,0,0,0,0,0,0,T,106
664,T Deep Apps Underpass/Apps Peek,Fallen,0,0,0,0,0,0,CT,106
665,T Deep Apps Underpass/Apps Peek,Fallen,1,1,0,206,145,61,T,106
666,Triple Box,Fallen,1,0,1,101,26,75,CT,106
667,Triple Box,Fallen,0,0,0,0,0,0,T,106
668,Bench Closer to Tribox,Fallen,0,0,0,0,0,0,CT,106
669,Bench Closer to Tribox,Fallen,0,0,0,0,0,0,T,106
670,Ladder Room Catwalk Side,Fallen,0,0,0,0,0,0,CT,106
671,Ladder Room Catwalk Side,Fallen,1,0,1,100,28,72,T,106
672,T Deep apps,Fallen,0,0,0,0,0,0,CT,106
673,T Deep apps,Fallen,0,0,0,0,0,0,T,106
674,CT Catwalk,Fallen,0,0,0,15,15,0,CT,106
675,CT Catwalk,Fallen,0,1,-1,0,99,-99,T,106
